New Music Friday 11/27/21 LyricsAnuel AA - Llorando en un Ferrari
Rod Wave - By Your Side
Jessie Murph - Always Been You
Kali Uchis - Another day in America (with Ozuna)
Alan Walker - Man On The Moon
$NOT - Go
42 Dugg - Can't Complain (feat. Reaper)
Montell Fish - Destroy Myself Just For You
Jack Kays - OUTRUN MYSELF (with Travis Barker)
Kota the Friend - Grateful
Mura Masa - 2gether
Claire Rosinkranz - don't miss me
Years & Years - Sweet Talker
AURORA - Midas Touch
Sech - Borracho
Blueface - Chose Me
midwxst - Shame
Ama Lou - Talk Quiet
Kurtis Wells - Forever Young ðŸ•’
Sipper - Losers
daine - IDC
Catie Turner - God Must Hate Me
Robyn Ottolini - Boujee On A Budget
John Summit - Human (feat. Echoes)
Gabry Ponte - Can't Get Over You (feat. Aloe Blacc)
Young T & Bugsey - Roberto C (feat. Unknown T)
TOKYOâ€™S REVENGE - AMAZING GR4CE
Nicky Youre - Sunroof
Cain Culto - Precious
Poppy Ajudha - LONDON'S BURNING
TCTS - Rich Girl
SpotemGottem - Got A Lil Older (with Hurricane Wisdom)
Duki - Midtown
NGHTMRE - Shady Intentions (feat. Tori Levett)
Bloc Party - Traps
Allie X - Milk
Dylan - You're Not Harry Styles
HIXTAPE - I Smoke Weed (feat. Ashland Craft & Brothers Osborne)
Matt Schuster - Haunted House
Donovan Woods - I Hope You Change Your Mind
Tom Rosenthal - Tractor
Pritty - Head Low
beaux - won't you take me far?
JXN - love sux
Jack Omstead - SHAMPOO
KEVVO - Cotidiano
Quando Rondo - The Realest
French The Kid - Uptown
KILLBOY - JUST SAY IT
Grace Aimi - Are You Okay?
Sody - Old Flame
Nicky Romero - Why Do I Call
Jonasu - On My Mind (with JC Stewart)
Yung Pinch - Alright
Damien - Drop Top
MIYA MIYA - Cool
Ivy Adara - Want What I Can't Have
Lowell - Black Boots And Leather Rebellion
Rnla - bad4me
Lime Cordiale - What's Not To Like
MICO - lie lie lie
NEIL FRANCES - finding rhythm
emie nathan - closed doors
Ash Olsen - DAT THING LIKE ME
Jac Ross - Never Say
Grace Davies - somebody
Jome - Floodgates
rosi - Here
Oslo Ibrahim - Strangers Again (feat. Pamungkas)
Madelline - Wish I could party all the time!
DEKKO - Bff <3
Steel Banglez - Tell Me (feat. Clean Bandit, Wes Nelson, Stefflon Don & Unknown T)
aldrch - gl4mour
CMTEN - 555
Jaguar Jonze - WHO DIED AND MADE YOU KING? - Feat. Shungudzo
Ghostface Killah - Bob James Freestyle
Yung Boi Rob - Trenches to Mansions (feat. Scorey)
Madison Ryann Ward - Love&Adoration
Young Bombs - U Up? (feat. Stondon Massey) ðŸ•’
Liv Dawson - Don't Let Me Lose You
morgen - Fine By Me
Kaylee Bell - Something I'll Never Get Back
Jon Bryant - Familiar Sound
love-sadKID - it's a long way home
YSN Fab - Hard To Replace
Chillinit - Dreaming Of This Day
Siiickbrain - Destructible
NEFFEX - Just Breathing
Karma Child - Eyes for U (feat. Conor Maynard & Gia Koka)
Nia Archives - 18 & Over
AVAION - Pieces
SERA - Take A Chance
Katie Tupper - How Can I Get Your Love?
Julie Bergan - Second Hand Love (feat. Ruben)
Nina Kraviz - This Time
Sevdaliza - The Great Hope Design
Pure Shores - Back On My Love ðŸ•’
HYBS - Dancing with my phone
MAX BARSKIH - Tequila Sunrise
El Fantasma - El Valor De Un VarÃ³nEmbed