New Music Friday 05/19/17 LyricsSelena Gomez - Bad Liar
Liam Payne - Strip That Down feat. Quavo
Bebe Rexha - The Way I Are (Dance With Somebody) feat. Lil Wayne
Katy Perry - Swish Swish feat. Nicki Minaj
Camila Cabello - Crying in the Club
XXXTENTACION - Looking for a Star
Robin Schulz - OK feat. James Blunt
Linkin Park - Sorry for Now
The Aces - Baby Who
Royal Blood - Hook, Line & Sinker
Francis and the Lights - May I Have This Dance (Remix) feat. Chance the Rapper
Lauv - I Like Me Better
Alan Walker - Tired feat. Gavin James
MORTEN - Keep Me From You feat. ODA
Muse - Dig Down
Phoenix - Ti Amo
MisterWives - Revolution
The Chain Gang Of 1974 - Looking For Love
A R I Z O N A - Running
Jasmine Thompson - Old Friends (Jonas Blue Remix)
RAYE - The Line
Iggy Azalea - Switch feat. Anitta
Vince Staples - Big Fish
Lil Yachty - X Men feat. Evander Griim
Katy Perry - Bon Appétit (MUNA Remix)
Seven Lions - Don’t Leave feat. Ellie Goulding
Ásgeir - I Should Live in Salt
CVBZ - Vicodin
Cloves - California Numb
Harlœ - More Than Ever
Buddy - World Of Wonders
The Preatures - Girlhood
Mondo Cozmo - Automatic
Jillian Jacqueline - Hate Me
Flor - warm blood
Terror Jr - Death Wish
OneRepublic - No Vacancy feat. Sebastián Yatra
Naaz - Words
Lana Del Rey - Coachella - Woodstock In My Mind
Grizzly Bear - Mourning Sound
Blink-182 - Last Train Home
Rancid - Telegraph Avenue
Papa Roach - Bleeding Through
All Time Low - Nice2KnoU
Nothing, nowhere - Clarity In Kerosene
Wild Cub - Somewhere
Ed Sheeran - Castle on the Hill (Seeb Remix)
Astrid S - Party's Over
DROELOE & San Holo - Lines of the Broken feat. CUT_
Local Natives - The Only Heirs
Wavves - No Shade
Leon Else - What I Won't Do
Tinashe - Flame (Kaskade Remix)
Pierce Fulton - Better Places feat. NVDES
Janelle Kroll - Barricade
Sabrina Claudio - Unravel Me
Andreas Moss - Stop Me
Lincoln Jesser - Somebody Will feat. Gabrielle Current
Broken Social Scene - Hug Of Thunder
Henry Jamison - The Jacket
Madison Beer - Dead
Kranium - Can't Believe feat. Ty Dolla $ign & WizKid
Danger Mouse - Chase Me feat. Run the Jewels & Big Boi
MIKExANGEL - One Time
Mali Music - My Life
Jay 305 - When You Say feat. Omarion
Elephante - Troubled feat. Deb's Daughter
Goapele - Stay feat. BJ The Chicago Kid
Gryffin & Illenium - Feel Good feat. Daya (Crankdat Remix)
Nick Hakim - Cuffed
Kirstin - Break A Little
Hillsong United - Wonder
Jason Isbell and the 400 Unit - If We Were Vampires
Rascal Flatts - Back To Us
Chris Cornell - SeasonsEmbed