New Music Friday 12/21/18 Lyrics21 Savage - monster
21 Savage - all my friends
5 Seconds of Summer - Lie To Me
A Boogie Wit da Hoodie - Demons and Angels (feat. Juice WRLD)
Sam Smith - Fire on Fire
Galantis - San Francisco (feat. Sofia Carson)
6LACK - Been A While
Casper Magico and Nio Garcia - Te Boté II
Lexy Panterra - Lies
Swae Lee and Rae Sremmurd - Ear Drummers Presents Christmas at Swae's
Danielle Bradbury - God Is A Woman - Yours Truly:2018
Florida Georgia Line - People Are Different
XYLØ - Freak
Kevin Gates and Moneybagg Yo - Federal Pressure
The Saboteurs - Now That You’re Gone
Cigarettes After Sex - Neon Moon
Slim Jxmmi and Rae Sremmurd - Ear Drummers Presents Nothing For Christmas
Brynn Cartelli - Last Night's Mascara
The-Dream - Bedroom
Goody Grace - Rest Your Eyes
Valee - About U (feat. DRAM)
Khalid and noclue? - Better - noclue? remix
Loren Gray - Queen
Alex Aiono - As You Need
Neon Indian - Heaven's Basement (Theme from 86’d)
Amenazzy and Nicky Jam - Baby
Heartsick - Loveltter
Shawn Mendes and Leon Bridges - Why - Remix
KREAM, Cazztek and Shoffy - Enough (with Shoffy)
Ryon's World and Faceless - Applesauce
MOTi and Sheezan - Hooked (Radio Edit)
Rudimental - They Don't Care About Us (feat. Maverick Sabre)
BB Nobre - Oportunidad
Pentatonix and Marren Morris - When You Believe (with Marren Morris) Black Stereo Underground
Christian French - someone new
Mighty Oaks - Like An Eagle
Los Puchos - Floating On The Water
Kyber Krystals - Taking Back My Life (Quiet Riot)
Sophie Rose - Best Friend
Robert Ellis - Passive Aggressive
The Chainsmokers and NGHTMARE VIP - Save Yourself - NGHTMARE VIP REMIX
Luke Christopher - DON'T LOOK BACK
Alanna Matty - Loved You First
Palm Trees and Sophie Ayana - They Told Me
Nipsey Hussle - Perfect Timing
Maluma and Becky G - Mala Mía (Remix)
Vindit - Sayeh
Fractures - Eastside
While She Sleeps - Haunt Me
Big K.R.I.T. - Energy
Yung Pinch - Cloud 9
The Kennedy Soundtrack - You Never Know
R3HAB and Jocelyn Alice - Radio Silence - Ryan Riback Remix
Sofi de la Torre - Voicebreaks
Wale - Winter Wars
Alice Glass - I Trusted You
Rompasso - Oxygen
flor - get behind this
LUCKI and Mick Jenkins - Trust Nobody
Emma Sameth and Jeremy Zucker - Spin With YouEmbed