New Music Friday 11/20/15 LyricsFLETCHER - Live Young Die Free
Alizzz - Your Love feat. Max Marshall
Belly - Might Not feat. The Weeknd
Basic Tape - Not Afraid
Shawn Mendes - I Know What You Did Last Summer feat. Camila Cabello
Ra Ra Riot - Water feat. Rostam Batmanglij
Brandyn Burnette - Made of Dreams
Maty Noyes - Haunted
G-Eazy - Drifting feat. Chris Brown & Tory Lanez
Kyla La Grange - Skin
Omarion - I'm Sayin' feat. Rich Homie Quan
Anne-Marie - Do It Right
Steve Angello - Prisoner feat. Gary Go
Classixx - Whatever I Want feat. T-Pain
David Guetta - Pelican
Mikie Snow - Heart is Full feat. Run the Jewels
Bobby Caldwell - Break Away feat. Jack Splash & Jessie Ware
Cloves - Don't You Wait
Cage the Elephant - Trouble
Baroness - Shock Me
Edward Sharpe & The Magnetic Zeros - Hot Coals
Kaptan - Closer Now
Satchmode - Further Away
Hugh - Almost Done, Almost There
Young Thug - Best Friend
Savages - T.I.W.Y.G
Elias - Green Eyes
MOTHXR - Touch
Rare Monk - Warning Pulse
George Cosby - State of Undress
Ro James - Permission
Jazz Cartier - Stick & Move
Chelsea Effect - Good Enough
ILoveMakonnen - Forever feat. Santigold & 1st
WatchTheDuck - Making Luv to the Beat feat. T.I. & DJ E-Feezy
LP - Lost On You
Leon Bridges - So Long
Wolfmother - Victorious
Detroit Grand Pubahs - SHOTTASoCo feat. Danny McBride
Allie X - Never Enough
YesYou - Through Your Eyes feat. La Mar
KLOE - Touch
Empire Cast - Powerful feat. Jussie Smollett & Alicia Keys
Krayzie Bone - Cloudy
Jay Prince - Juice feat. Allan Kingdom
Freddie Gibbs - Extradite feat. Black Thought
Bibio - Petals
Sofi de la Torre - 19 in Mexico
Sunflower Bean - Wall Watcher
David Bowie - BlackstarEmbed