New Music Friday 01/14/22 LyricsGunna - P power (feat. Drake)
Cordae - Chronicles (feat. H.E.R. & Lil Durk)
FKA twigs - jealousy (feat. rema)
Kane Brown - Whiskey Sour
Chris Brown - Iffy
Avril Lavigne Love It When You Hate Me (feat. blackbear)
Oliver Tree - Cowboys Don’t Cry
YoungBoy Never Broke Again - Foolish Figure
NLE Choppa - Too Hot (feat. Moneybagg Yo)
Mitski - Love Me More
Aluna - Forget About Me
Stromae - L’enfer
Lil Wayne - Anti-Hero (feat. Lil Tecca)
Tai Verdes - LAst dAy oN EaRTh
Peter McPoland - String Lights
The Lumineers - WHERE WE ARE
Kota thе Friend - Bitter
Murda Beatz - Onе Shot (feat. Blxst & Wale)
King Princess - Little Bother (feat. Fousheé)
Muse - Won’t Stand Down
Bastille - Shut Off The Lights
Anson Seabra - Come Close
Charlieonnafriday - On My Own
Tyla Yaweh - Do No Wrong (feat. Trippie Redd & PnB Rock)
JID - Surround Sound (feat. 21 Savage & Baby Tate)
Joey Bada$$ - THE REV3NGE
Mau y Ricky - No Puede Ser
Years & Years - Sooner Or Later
Cautious Clay - Rapture In Blue
Oscar Scheller - Hard Being Alive (feat. Chloe Moriondo)
Earl Sweatshirt - Lye
Ant Clemons - Come With Me
Jason Aldean - Trouble With A Heartbreak
Brett Eldredge - Want That Back
John K - A LOT
Hippo Campus - Ride or Die
Sebastian Yatra - Regresé
Russ - Remember
Saba - Come My Way (feat. Krayzie Bone)
EARTHGANG - All Eyes On Me
BEAM - WIN
Vaultboy - i think i wanna text u
Sofia Carson - LOUD
Haley Joelle - Memory Lane
Bonobo - Age of Phase
Lucius - Next to Normal
Eddie Vedder - Brother the Cloud
Thomas Rhett - Angels
Conner Smith - Somewhere In A Small Town
CNCO - Party, Humo y Alcohol
Bob Moses - Love Brand New
ENHYPEN - Blessed-Cursed
Stephanie Poetri - Picture Myself
Barrie - Quarry
Cavetown - squares
Yot Club - It's Easy
Jacques Greene - Taurus
Babyface Ray - Dancing With The Devil
Popp Hunna - Back It Up
Token - Boom (ft. JID)
AZ - Motorola Era
Stand Atlantic - pity party (feat. Royal & The Serpent)
Valley - Last Birthday
Ai Bendr - I Never Learn
BAYNK - Naked
Frank Walker - Day By Day
Kojey Radical - Payback (feat. Knucks)
Johan Lenox - No One Gets Me (feat. RMR)
BUZZ - Liberation
Niko Rubio - Hold Me Down
Hailey Whitters - Everything She Ain’t
Danielle Bradbery - Break My Heart Again
The Wombats - This Car Drives All by Itself
LAUNDRY DAY - Did You Sleep Last Night?
The Simps - Tesla
Yeule - Too Dead Inside
The Knocks - Walking On Water
SIDEPIECE - Sextacy
Erica Banks - The Best
KDVSGOLIATH - BANTER
Wintr - Consequences
Matisyahu - Keep Coming Back for More (feat. Salt Cathedral)
Amanda Reifer - Bag
Abby Roberts - Paramaniac
Natalie Jane - Kind of Love
Against The Current - Wildfire
Skillet - Destiny
Elvis Costello - The Boy Named If
Henry Jamison - Make It Out (feat. Maisie Peters)
Aldous Harding - Lawn
Lael - you can't stay mad at me
Dexter - Different
HAZEY - Packs and Potions
Keedron Bryant - Passing Thru
Wisin - Buenos Días
Tenille Townes - When's It Gonna Happen
Ben Kessler - AprilYou might also likeEmbed