Curated By: Taylor Swift LyricsJon Bellion - 80's Films
Ariana Grande - Everyday (feat. Future)
NEIKED & Dyo - Sexual
Chris Stapleton - Fire Away
James Blunt - Love Me Better
Good Old War - Part of Me
The National - Dark Side of the Gym
HAIM - Ready For You
The xx - I Dare You
Niall Horan - Too Much To Ask
SYML - Better
Lana Del Rey - Tomorrow Never Came (feat. Sean Ono Lennon)
Dum Dum Girls - Coming Down
Ed Sheeran - Perfect
Danny Padilla - Too Bad
Rihanna - Close To You
Kehlani - Advice
Halsey - Is There Somewhere
Arcade Fire - We Don’t Deserve Love
Marc E. Bassy - Subway Car
Iron & Wine - Call It Dreaming
Dierks Bentley - Black
Joel Baker - No One In Heaven
The Chainsmokers & Coldplay - Something Just Like This
James Cherry - Hold On (Stripped Version)
Selena Gomez - Nobody
Liam Gallagher - For What It's Worth
Betty Who - Blue Heaven Midnight Crush
Lady Gaga - The Cure
Lana Del Rey - Love
Volcano Choir - Comrade
Miley Cyrus - Malibu
Aaron Espe - Making All Things New
Midland - Drinkin' Problem
Kesha - Learn To Let Go
The-Dream - Code Blue
Brett Young - Like I Loved You
Shawn Mendes - Bad Reputation
The Pierces - We Are Stars
Wrabel - Bloodstain
Haux - Youth
Banks - Crowded Places
Rihanna - Kiss It Better
Kings of Leon - Reverend
Maren Morris - Sugar
Bon Iver - 8 (Circle)
Kendrick Lamar - LOVE. (feat. Zacari)
Cole Swindell - Middle of a Memory
Sleeping at Last - Atlas: Body
The National - Carin at the Liquor Store
Ryan Hurd - Love in a Bar
Aquilo - You Won’t Know Where You Stand
J Hus - Did You See
Charli XCX - Boys
Vindata, Skrillex, & NSTASIA - Favor
Khalid - Shot Down
Daniel Caesar - Japanese Denim
Keaton Henson - Alright
Bleachers - Let's Get MarriedEmbed