March 2022 Singles Release Calendar Lyrics3/1Coop - "PSA"
Drew Ava - "South Florida"
Ejiro - "Your Love"
J. Monty - "On Gang"
Micah Smith - "We Must Grow"
Os Meireles - "Invencível"3/2Detroit Altar Music - "Psalm 46" feat. Cyle Pickett & Esther Baban
Poor Bishop Hooper - "Psalm 114"
Vancouver Sleep Clinic - "Love You Like I Do"
Wolves At The Gate - "Deadweight"3/3Fuego - "El Viaje" feat. Sebas Guillem
Gabriela Rocha - "Águas Purificadoras"
Konata Small - "Madness" ⏳
Midian Nascimento, Coletivo Candiero & Calmará - "Maria Vai Com as Outras"
PEDRAZUL - "Melhor Amigo"3/4Aaron David - "Brand New"
Anne Wilson - "Hey Girl"
Barely Trev & Paul Russell - "yours!"
Ben Laine - "Herе To Stay" ⏳
Black Voices Movement & Circuit Ridеr Music - "Let The Redeemed Of The Lord Say So (Live)" feat. Jonathan Stamper, Eniola Abioye & Alvin Muthoka ⏳
Blanca & Dante Bowe - "The Healing"
Burgeon - "Sun's Smooth Rise"
Cassio Petronilo - "Amém"
Christian Singleton - "Who You Want Me To Be" ⏳
Claire Odogbo - "For Your Glory"
Common Hymnal - "On My Way" feat. Dee Wilson, Royce Lovett, Seb Camry & Seaux Chill ⏳
Danny O'Callaghan - "Runaway" ⏳
Deep Valleys - "You Found Me in the Universe"
DJ Mykael V - "HVNSNT" feat. Foggieraw & Britton Rauscher
Eleni Baker - "Better"
Eliza King - "Secret Place"
Foothills Worship - "Lord of Every Man" ⏳
Gas Street Music - "Keep On Proving It (Live)" feat. Millie Ferguson & Taku Mudere
Gordy - "BUST"
HYLEM - "Don't wanna run" feat. simplyollie ⏳
Isaiah Robin - "Light" ⏳
Ivanzinho Deusamba - "Nunca Deixa de Me Amar" ⏳
Jervis Campbell - "Teach Me to Dance (Acoustic Version)" feat. Chris Renzema
JJ Heller - "Good Idea"
John Michael Howell - "NEVER CRY AGAIN" ⏳
Jordan Marcotte - "Wonderful" feat. Benji
Josh Wilson - "Things That I'm Afraid Of"
Judikay - "Elohim" ⏳
Kenny Hass - "First Time Again" ⏳
Kojo Dave & Shirlvin Desir - "Nobody" ⏳
Likewise Worship - "Be Glorified"
Matt Maher & Lizzie Morgan - "Leaning (Live)"
Marvin Sapp - "All in Your Hands" ⏳
Mike Teezy - "Y C S M N" ⏳
More Rain - "Communion Song"
North Point Worship - "God Is Love (Live)"
ØM-53 - "ghost me (slow)"
Pegs XO - "On My Mind" ⏳
Providence - "God, Be Merciful to Me"
Rebekah Renatus - "Supreme Love"
ReFRESH Worship - "Cry Out" feat. Naomi Raine
Requiem Heist - "Palms"
Rev Music & Swift Andre - "See Revival (Live)"
RICHLIN - "Good Mood"
Ryan Hylton - "No Other" feat. Amanda Kono
Sada K. - "Sound Soul"
Saint James - "No One's Gonna Save Me"
Sandra McCracken - "Dreams" feat. Molly Parden ⏳
Shelley E. Johnson - "Power of the Cross"
The Porter's Gate & Liz Vice - "Brother Sun (Giving Glory!)" ⏳
Thiago Grulha - "Pertinho do Coração"
Watermark Music & Shane & Shane - "Let It Be Real"3/6Lifegate Worship - "Our Father In Heaven"3/7knwbdy - "4myfrenemies" feat. Spencer Boliou & wins ⏳
Townix - "Tikiti"3/8For Tuesday - "Closer Than A Brother" ⏳
Swaizy - "oxygen"3/9José Jr - "Em Ti (Ao Vivo)"
Jubilee Worship - "God Of The Promise"
Poor Bishop Hooper - "Psalm 115"3/10George.Rose - "Hit On That Switch" feat. 350 ⏳
S.O. - "BADMAN"
Victor Huna - "Amanheceu"3/11Ale Fdz - "Gloria"
André & Felipe & Isadora Pompeo - "Cuido dos Detalhes"
Asha Elia - "New Me"
Battz & Aaron Dews - "DNA"
Brenda Guisande - "Warfare" feat. Jordan Guisande & Autopilot Worship ⏳
Chelsea - "How Can I Be Silent" ⏳
City Impact Church - "Your Love Your Love" ⏳
Coby James & Evvie McKinney - "Shackles (Praise You)"
Colorvault - "No One Like You" feat. A.Bishai
Coop - "Outro to Exile" ⏳
CRFT, Coop & Christopher Syncere - "Father Got a Plan" ⏳
Damaris Guerra - "Mi Único Amor" feat. Louis Sanchez
Dara Maclean - "Full Access"
Doug Mathis - "King of Love"
ELEVATION RHYTHM - "Fake Love"
Eva Swanson, Calibleubird & KnowGood - "Path of Life"
FAITHFUL - "The Detour (Live)" feat. Sarah Kroger, Savannah Locke & Tamar Chipp ⏳
Gabby Callwood - "Dangerous" ⏳
Gateway Worship Español & Miel San Marcos - "Poderoso Dios (Grande Y Fiel)"
Gatherhouse Music - "Honeycomb Song (Taste & See)" feat. Charity Gayle
Glasslands - "Mad"
I AM THEY - "Gratitude"
Imago Dei - "Just Can't See" feat. Cade Legat ⏳
IMRSQD, Moflo Music & Sammie Lee - "Pilot"
Joe Garza - "God's Plan"
Jon Keith & 1K Phew - "NO GOOD"
Joshua Luke Smith & Wild Sons - "Echo" ⏳
Kalin Jones - "Blessings On The Way" feat. CJ Pitts & Artillery ⏳
Kayla Thompson - "Younger"
Kel Mitchell - "Blessed Mode" feat. Scootie Wop & nobigdyl.
Kenny Rivers - "DUELE" ⏳
Lara Neumann - "Touch Of Grace" feat. Kim Walker-Smith ⏳
Life.Church Worship - "Grace Upon Grace"
Lifepoint Worship - "To Know You" ⏳
Lloyd Nicks - "Learning to Forgive"
Mikey Powell - "Is There Anything Too Hard For You" ⏳
Mosaic MSC - "Unexpected Roads"
Moses Brothers - "Trustfall" ⏳
Muntjac - "Alpha to Omega" ⏳
Names Without Numbers - "You Do The Talking"
New Life Worship - "Spirit of God (Flame of Love) [Live]" feat. Micah Massey
Oba Reengy - "Aware"
O'Bros - "Wunden zu Wunder"
Phil J. - "Like That" ⏳
Princeton South & Sal Ly - "Supernaturally" ⏳
Providence - "Our Boast" ⏳
RAY G & OnBeatMusic - "BIG WIN" feat. George.Rose & Red Tips ⏳
Rend Collective - "Tell Me Ma (Belfast City)"
Ri-An - "Lily of the field"
Ryan Ofei - "Keep Praying (Live form Studio 20/20, Acoustic)" ⏳
Sansone - "In My Head"
Savannah Gibson - "Great Unknown"
Secret! - "Level Up!"
SEMAJE - "Lovely Day" ⏳
simplyollie - "Runaway"
SIV - "It's Never Too Late"
SoulDevotion Music - "Ich hör niemals auf"
Steven Malcolm - "Ain't Playin'" feat. Social Club Misfits
Taylor Armstrong - "heaven come"
Tedashii - "Mirror Talk"
Tedashii - "OBJ"
The Altar Music - "Follow the Lamb"
The Belonging Co & Cody Carnes - "Firm Foundation (He Won't) [Live]"
Tom Read - "78 (Hidden Things)" ⏳
Tylynn & Lite Pole - "BOTS (Freestyle)" ⏳
United Pursuit - "Standing Tall"
Via Music - "Working On It" ⏳
WE ARE ONE - "Future"
White Ribbon Day - "Across the Water"
WorshipMob - "I Know You Better" ⏳
Yaïr - "Petit Prince"3/13Kevin Yamil - "Te Bendeciré"
Testify - "From Death To Life"
1K Famo - "Boys In Motion" feat. 1K Phew, 1K Pson, Don Tino, Chris Elijah, I Am Chozen & AJ The Great ⏳3/14CantoVerbo - "Peregrino" ⏳
Jonah Vocal - "Walls"3/15Brian Kim & 김브라이언 OVERFLOW- "The Holy Spirit's Come"
Hyper Fenton - "Next Move" ⏳
Lois Mahalia - "Sacred Ground" ⏳
Marco Elizalde - "Tu & Yo"3/16Leslie Perez - "Remedy"
Lev - "Nog altijd wie U was"
Poor Bishop Hooper - "Psalm 116"3/17Kike Pavón - "Tierra Prometida"
Nós em Um - "17:15"3/18Adelitas Way & New Medicine - "Up"
Alex Campos - "No Dejes Que Caiga"
Alphein & JKO - "30 Degrees" ⏳
Amanda Cook - "While We Wait"
Anthony Brown - "Drink" feat. Naomi Raine
Austin Stone Worship - "Hope Is Awake"
Ben Fuller - "Who I Am"
Ben Laine - "Why Am I Not Yours" ⏳
BigGucciDame & Gabby Callwood - "How U Do It"
Branan Murphy - "Love Won't Let Go"
Breanna Corjuc - "I Will Triumph" ⏳
Canvas House Worship - "Me Rodeas"
Canyon HIlls Worship - "Mercy of Jesus" ⏳
Dan Bremnes - "Lover Of My Soul"
Danielle Apicella - "Souls Craving"
Deitrick Haddon - "God Made" ⏳
Elias Dummer - "See Clearly" feat. Sandra McCracken
Erica Campbell - "Positive" ⏳
Harborside Music - "Worthy" ⏳
Hillside Recording & Eliza King - "Let Go" ⏳
ID2 - "Entregue em Teu Amor"
James David William - "Temple"
jaylen. & ohsobrkn - "PLANTED"
Jildou - "Minnesota Sky"
JJ Heller - "Rainbow Connection"
John Mark McMillan - "Prove My Love"
John Michael Howell - "Mistakes Were Made" ⏳
Jonny Henninger & Eliza King - "What Would I Gain?"
Johnnyswim - "Desmond's Song" feat. Tobe Nwigwe
Jon Webster - "wanna"
Jovan Whyte - "You Win" ⏳
Justin Tweito - "King of Humility (Live)"
Kinnship - "Better Man Like Me"
Kristene DiMarco - "Gravity" feat. kalley
Leah McFall - "Outside the Lines"
Local Sound - "More Than Halfway"
Lute & Lyre - "Fire and Flood"
Manor Collective - "Not By Might" feat. Charlotte Kiwanuka, Junior Garr & Elle Limebear
Mission House - "If I Was A Bird (Live)" feat. Jess Ray & Taylor Leonhardt ⏳
Mission House - "Nothing Left To Do (Live)" feat. Jess Ray & Taylor Leonhardt
North Point Worship - "Prodigals (Live)"
One Luke - "High Note" feat. Miles Minnick ⏳
PEABOD - "Spring Theory"
Phil Laeger - "Your Love Is Better" feat. Sheena Marquis ⏳
Prodi Da Prodigal - "Gucci" feat. Battz ⏳
Protek Illasheva - "On God" feat. Limoblaze & Prinx Emmanuel ⏳
Providence - "Hallelujah, What a Savior!" ⏳
Reclaimers - "Fight"
Rehmahz, Sarah Nathalié & IMRSQD - "Relying"
Rob Nightingale - "Awake Your Church"
Ryan Ellis & DOE - "Heart of the Father"
Shane & Shane & The Worship Initiative - "Hallelujah's Song (Psalm 103) [Live]" ⏳
Shelly E. Johnson - "Living in Your Goodness"
Sinach - "A Million Tongues"
Souffle Nouveau & Jimmy Lahaie - "Je te donne"
Susie Mills - "Darlin'" feat. Joshua Luke Smith
TAYA - "For All My Life"
TEMITOPE - "STILL HERE (LIVE)" ⏳
Tempest Calm - "Bronze Wings" ⏳
The Worship Initiative & Davy Flowers - "Only There (Live)"
Travis Ryan - "Our King is Coming Soon" ⏳
Todd McVicker - "So Brand New (Live Tapes)" feat. Isaiah Schuman ⏳
Tommy Royale - "Tengo La Luz" ⏳
Virginia Arruda & Michael Bethany - "Holy"
Wade Walker - "Perennial" feat. Nicole Tester
WHATUPRG - "KIDS"
When Forever Ends - "Arbiter" feat. Jack Daniels
YouthFR - "Oasis (Terres arides)"
29:11 Worship - "Say It Again" feat. Zion Rempel & Justice Couch ⏳3/19Enni Francis - "Kumama Papa"3/20Zhalarina - "Tested"3/21KJ-52 - "No Turning Back" ⏳3/22Alexxander - "Todo Por Ti" ⏳3/23Barak - "Fuego & Poder"
Poor Bishop Hooper - "Psalm 117"
Q-Flo - "Game Time" feat. Aable & Prodi Da Prodigal ⏳
The New Sound Is Family - "Never Thirst Again (On and On)" feat. Michael Howell & John Michael Howell ⏳3/24Dri do Sol, Marco Telles & João Manô - "Do Que Somos Feitos" feat. Filipe da Guia & Coletivo Candiero ⏳
Joey Vantes - "The Great Reset" ⏳
Nós em Um - "Rotina"
Samuel Troc - "Pasado Pisado" ⏳3/25A Beauty Initiative Within Focus - "Very Good" feat. Parker Staub ⏳
Amongst the Giants - "Black Box"
Andie Elise - "Courage, Dear Heart" ⏳
Angeloh - "For You"
Annatoria - "Stay with Me" ⏳
Bicq & Ben Potter - "10k Reasons"
Brandyn Kalani - "GOOGLE MAPS"
Britt - "Limón y Sal"
B-Shoc - "Your Love" ⏳
Calder the Band - "Dandelion" ⏳
Caleb Gordon - "Haha!" ⏳
Calvary Worship - "Sons + Daughters" feat. Israel Houghton & Eternia ⏳
Christian Singleton - "Your Love" ⏳
Christopher Syncere - "NOBODY KNOWS"
Cochren & Co. - "Thank God for Sunday Morning"
Common Hymnal - "Up" feat. Seb Camry, Phillip Joubert, Canon, Sharon Irving & Vincent Charlow ⏳
CRFT - "Gratitude" feat. Battz & nobigdyl. ⏳
Daphne Richardson - "Heavy"
ELEVATION RHYTHM - "Growing Pains" feat. Mitch Wong
Gateway Worship - "Living God" feat. Zac Rowe
Gwil Davey & Jemimah Paine - "Who is like you Lord?" ⏳
Holly Halliwell - "Basics"
ICF Worship - "Only You"
ISLY - "More Than the Stars"
Jake Layne & Noah Paul Harrison - "Clarity"
Jeremiah Paltan & KDNS - "Ascend"
Jim Sonefeld - "Bow To Him" ⏳
John Mark Pantana - "Home"
John Mark Pantana - "Rooftop"
Jonathan David Middleton - "Streams" ⏳
Josh Blakesley - "Jesus I Trust In You"
Joshua Luke Smith & Wild Sons - "Hold Me Back"
Justin Unger & Likewise Worship - "What If" ⏳
Karissa Frampton & Matthew Scheall - "Everything" ⏳
Khorus & Lito Atalaia - "A Voz de Brasil" ⏳
Lamarr Lyons - "Time" ⏳
Lovd Ones & Benjah - "A Good Day"
Manafest - "NEMESIS" feat. Sonny Sandoval
Maurice Kirya - "Entebbe" ⏳
Mervin Mayo - "The Best Friend"
MvkeyyJ - "hands in the sky"
Mystro Productions & Kylie Odetta - "Abide" ⏳
Nate Rose & Jon Keith - "Flip"
Nathan Wagner & 4th Point - "Think of Me"
Nolen Durham - "Rip My Heart"
Noontides - "Stride"
Novo Tempo, Ronaldo Fagundes & Alisson Melo - "Escolhi Louvar o Teu Nome" ⏳
O Bairro Novo - "Louvor III"
Okey Sokay - "Ike" feat. Limoblaze ⏳
Paul the Messenger - "Happier"
Paul Zach & Wendell Kimbrough - "The Lord Our God Is Good" ⏳
Polskie Znaki - "Oh Angel" ⏳
PRISMA Más Vida & Ale Fdz - "Mil Preguntas" ⏳
Rebekah Renatus - "Presence"
Red Letter Society - "CANYON"
RIDERS & Circuit Rider Music - "1:11" ⏳
Rob Ray - "Confession" ⏳
Ro CV - "You Made Me New"
Roy Tosh - "You're Ready" ⏳
Sam Hibbard - "Behold the Son"
Sandra McCracken & David Ramirez - "Running On Empty" ⏳
SEU Worship & David Ryan Cook - "Familiar Song"
Shan Ako - "God's Best" ⏳
Stars Go Dim - "Prepare The Way" ⏳
Stephen McWhirter & Jason Clayborn - "King of Kings" ⏳
Stephen Stanley - "Note To Self"
Taylor Armstrong - "storms"
TBabz, Asha Elia & A Mose - "Lay Low" ⏳
Tee-Wyla - "NORF" feat. Aable, Q-Flo & Prodi Da Prodigal
The Coloring Fields - "distract your distractions" feat. tyler richardson
The Jonah Project - "Psalm 68" ⏳
Tribl & Maverick City Music - "Too Good Not to Believe" feat. Lizzie Morgan, Melvin Crispell III & Cecily
Vic Lucas & Xay Hill - "All On Him" ⏳
Vive Worship - "This Is the Gospel (Live)" feat. Joe Pringle
Wande - "They Didn't Know II"
Watashi Wa - "Let Me Prepare You" feat. Gasoline Heart ⏳
Watashi Wa - "Trust Me" feat. Dogwood & Saint Didacus ⏳3/26Harvest Sound - "Your Love Brought Me Home (Live)" feat. Daniel MacLeod, David Dennis, Jonathan Hutcherson ⏳
LÉA-SOPHIE - "Dein Kreuz" ⏳
Reconcile - "I Know That You're With Me" ⏳3/27Convergência Music & Os Dias - "Vale da Visão"3/28Navyug - "saviour" ⏳3/29Hillary Scott - "You Can Rest"
J. Monty - "Pastor Monty"
Kyrios - "Cansado Del Camino"
Lissa Subira - "Voz de Muitas Águas" feat. Beatriz Hummel
verboemcarne & Ana Heloysa - "justiça, paz, alegria"
YB - "Neon Freestyle" ⏳3/30Beach Chapel - "aren't i"
Felipe Câmara & Malú Lomando - "Agora"
Poor Bishop Hooper - "Psalm 118"
Svvn - "Evaporate"
Vincent Jacob - "De Hemel Is Eenzaam" ⏳3/31Bec Armour - "Perfect Peace" ⏳
Dirk - "Always" ⏳
Eyshila, Fernanda Brum & Aline Barros - "Ele Se Move"
Nós em Um - "Oração"Embed