New Music Friday 06/29/18 LyricsDrake - Don’t Matter To Me
Drake - Talk Up
Drake - 8 Out Of 10
Drake - In My Feelings
OneRepublic - Connection
Florence + The Machine - Patricia
Charli XCX - Focus
Teyana Taylor - Rose In Harlem
MAX - Still New York
88rising - Warpaint
Bad Bunny - Estamos Bien
HONNE - I Got You ◑
Jonas Blue - I See Love
Nicky Jam - X (Remix)
Axwell /\ Ingrosso - Dancing Alone
Mason Ramsey - The Way I See It
Yung Bans - Ridin (feat. Landon Cube & YBN Nahmir)
Bullet For My Valentine - The Very Last Time
¿Téo? - Américano
The Blaze - SHE
Filmore - Love That About You
The Brummies - Drive Away
A$AP Ferg - Verified
Jozzy - Push Thru
88rising - Let It Go
King Henry - Bad for Me
Sean Paul - Bad Love
Rudy Mancuso - Mama
Breathe Carolina - Feel It
Mike Perry - Don't Hide
Mondo Cozmo - Tonight Tonight
Years & Years - All For You
Dean Lewis - Be Alright
Benny Benassi - Everybody Needs A Kiss
Gorillaz - Tranz
Ella Vos - You Don't Know About Me (The ACLU Remix)
Labrinth - Same Team
AJ Mitchell - Girls
lovelytheband - alone time
NOVAA - Club Paradise
Wiz Khalifa - Gin & Drugs (feat. Problem)
Hillsong Young & Free - Every Little Thing
Sheryl Crow - Wouldn't Want To Be Like You (featuring Annie Clark)
Hot Since 82 - Buggin' (Edit)
Big Pineapple - Another Chance (Don Diablo Edit)
SACHI - Hollywood Angel
James Vincent McMorrow - Me and My Friends
EDEN - about time
St. Paul & The Broken Bones - Apollo
Mansionair - Technicolour
YoungBoy Never Broke Again - RIP (feat. Offset)
Mitski - Nobody
Let's Eat Grandma - I Will Be Waiting
Kenny Chesney - Pirate Song
for KING & COUNTRY - Pioneers
Midland - Burn Out (Recorded At Sound Stage Studios Nashville)
The Knocks - Shades
Shallou - Lie (Le Youth Remix)
Ozuna - Vaina Loca
All Time Low - Birthday
Love and Theft - You Didn't Want Me
XYLØ - Don't Panic
Olivia O'Brien - RIP (Remix)(feat. G-Eazy & Drew Love)
Pale Waves - Noises
Michl - Tell Her
Daisy Gray - Saviour (Acoustic)
cleopatrick - youth
Devault - Stay (feat. Njomza & Bipolar Sunshine)
Passenger - Runaway
Chocolate Puma - Tear This Mother Down (feat. MX2)
TIEKS - Break the Rules
MOTi - I See Light In You (feat. Faye Medeson)
Bearson - I Only Need One (feat. MNDR)
Eny - Until Next Time
boy pablo - Sick Feeling
Martin Solveig - My Love
The Aston Shuffle - Everything I Got
Blanco White - Olalla
Louie Vega - Last Night A DJ Saved My Life (feat. Anané & Tony Touch)
Phil Wickham - Song In My Soul
Ruston Kelly - Jericho
The Interrupters - Gave You Everything
The Score - Glory
Casanova - Down Bitch
LöKii - Lovers
ayokay - Half Past You (feat. Future Jr.)
dijon - WILD
Allen Stone - Warriors
The Wild Feathers - Quittin' Time
Randy Houser - What Whiskey Does
Smalltalk - YoungEmbed