New Music Friday 11/02/18 Lyricsbenny blanco - I Found You (with Calvin Harris)
Imagine Dragons - Machine
Metro Boomin - Only You (feat. WizKid, Offset & J Balvin)
Kid Ink - No Budget (feat. Rich The Kid)
Martin Garrix - Dreamer
King Princess - Pussy Is God
THEY. - Broken (feat. Jessie Reyez)
Carly Rae Jepsen - Party For One
Trey Songz - Shootin Shots (feat. Ty Dolla $ign & Tory Lanez)
Hailee Steinfeld - Back to Life
Anne-Marie - Perfect To Me
NOTD - So Close
Tyga - Dip
H.E.R. - Carried Away
Troye Sivan - Somebody To Love
Pink Sweat$ - Drama
Lil Peep - Runaway
Hayden James - Better Together
Little Mix - Joan of Arc
Jon Bellion - Stupid Deep
Mikey Mike - Strange Times
Takeoff - Casper
Moneybagg Yo - Say Na (feat. J. Cole)
Clean Bandit - Baby (feat. Marina and The Diamonds & Luis Fonsi)
Metro Boomin - No More (feat. Travis Scott, Kodak Black & 21 Savage)
Anuel Aa - Ella Quiere Beber - Remix
BlocBoy JB - Don't Say That (Feat. Lil Uzi Vert)
Mariah Carey - A No No
Aya Nakamura - La dot
Alec Benjamin - 1994
Sabrina Carpenter - Bad Time
Wolfgang Gartner - Good Medicine (feat. Rush Davis)
Galantis - Emoji
Tim McGraw - Gravity
Blackway - What's Up Danger (with Black Caviar)
Deerhunter - Death in Midsummer
gnash - nobody's home
Slipknot - All Out Life
Cale Dodds - Where I Get It From
Pistol Annies - Got My Name Changed Back
Sia - Mountains (with Sia, Diplo & Labrinth)
j ember - nothing left
Blake Rose - Hotel Room
NAV - Know Me
DYLN - Without You
James TW - Soldier
Kris Wu - November Rain
isaac gracie - you only live once
Katy Perry - Waving Through A Window
ROSAL√çA - DI MI NOMBRE - Cap.8: √âxtasis
Samuraii - Changed My Mind (feat. Loote)
Jade Bird - Love Has All Been Done Before
Lil Durk - Neighborhood Hero
Action Bronson - Swerve On Em (feat. A$AP Rocky)
Henry Jamison - Boys
Panic! At The Disco - The Greatest Show
Jacob Banks - Caroline
Theophilus London - Only You (feat. Tame Impala)
El Alfa - Mi Mami
UPSAHL - The Other Team
Anna Of The North - Nothing Compares 2 U
Crowder - Let It Rain (Is There Anybody)
Jacob Collier - With The Love In My Heart
Simmy - Ngiyesaba
Charlotte Cardin - Double Shifts
Glades - Sweetheart
Jay Sean - Say Something
Carly Pearce - Closer To You
Fly By Midnight - You Belong
Ty Brasel - All At Once +
Georgia - Started Out
EMAN8 - Amen
Mimoza - Love for Days
Sofi Tukker - Cry For You (Recorded at Spotify Studios NYC)
Mikky Ekko - Let You Down
Slow Pulp - Steel Birds
Sam Fender - Waiting For Love (Recorded At RAK Studios, London)
Skrizzly Adams - Take a Sip üêö
Justin de Mari - Without You
L.I.F.T - a vampire.
Karol G - Cr√©eme
NVDES - Running (feat. Oliver Tree)
BR√çET - Carousel (feat. Steinar)
Michael Ray - Psycho - Recorded at Sound Stage Studios, Nashville
Sick Of It All - Wake the Sleeping Dragon
Des Rocs - The Past Has Passed Away
The Brilliance - Oh Dreamer
Kidpenny - We'll Get There Together
Maisie Peters - Feels Like This
Eearz - Kill 'Em With Success (with ScHoolboy Q, 2 Chainz & Mike WiLL Made-It)
Hollywood Undead - Bloody Nose
Tarn PK - Talk To You
Noelle Scaggs - Great For You (feat. BR√ÖVES)
RY X - Bound
Timeflies - Back When We Were Kids
Saint Slumber - FEVER
P.O.D. - Fly Away
Sundara Karma - One Last Night On This Earth
Hiss Golden Messenger - Issa
Rival Sons - Back In The WoodsEmbed