New Music Friday 3/6/20 LyricsBazzi - Young & Alive
Megan Thee Stallion - Captain Hook
Demi Lovato - I Love Me
Katy‚ÄÖPerry‚ÄÖ- Never Worn‚ÄÖWhite
Lil Uzi Vert - That Way
Jhen√©‚ÄÖAiko - B.S. (feat. H.E.R.)
Bad Bunny - La Dif√≠cil
Lauv - Invisible Things
Alaina Castillo - ocean waves
Dixie Chicks - Gaslighter
Trevor Daniel - Past Life
Gunna - SKYBOX
BROCKHAMPTON - SUGAR (Remix) [feat. Dua Lipa]
LoveLeo - ROSIE
Alec Benjamin - The Book of You & I
HAIM - The Steps
Niall Horan - Lover - Recorded at Air Studios, London
Mickey Guyton - What Are You Gonna Tell Her?
merci, mercy - Fucked Myself Up
brakence - fwb
Jessie Reyez - ANKLES
Rich The Kid - Red
Rina Sawayama - XS
Shoffy - Tricky (feat. Sabrina Carpenter)
Louis The Child - Every Color (with Foster The People)
AJ Mitchell - Spring Break (feat. Rich The Kid)
Blacc Zacc - Bang (feat. DaBaby)
Lil Skies - Havin My Way (feat. Lil Durk)
Buscabulla - NTE
Empress Of - Give Me Another Chance
Alesso - One Last Time
Steve Aoki - Halfway Dead (feat. Global Dan & Travis Barker)
Bad Bunny - La Santa
Austin McBroom - Only One
Rod Wave - Thief In The Night
Healy - Nikes On
Christian French - crowded room
Mandy Moore - Tryin' My Best, Los Angeles
Lauren Alaina - In My Veins
X Ambassadors - Belong
flora cash - Still Alive
Blueface - Holy Moly (feat. NLE Choppa)
88GLAM - Swim
JAHMED - JEEP
Ro James - Touchy Feely
Absofacto - Lemon Drop
[Kleerup - I Don‚Äôt Mind] üêö
Grace VanderWaal - Today and Tomorrow (From Disney's Stargirl)
Phantogram - Dear God
The Aces - Daydream
Little Dragon - Are You Feeling Sad?
Dalex - Perfume
Ashnikko - Tantrum
$NOT - PRESSURE
POORSTACY - Darkness
Bush - Flowers On A Grave
PVRIS - Dead Weight
Kito - Alone With You (feat. AlunaGeorge)
Christian Paul - Here Tonight
Lola Young - Pick Me Up
The Mar√≠as - Hold It Together
M.O - Going Out Of My Way (feat. Mr Eazi)
Leven Kali - 12345 (Get Real)
Kranium - Money In The Bank (feat. Kelvyn Colt)
[Day Sulan - Mascara] üêö
Ebenezer - 3am in London
RARE Sound - Big Dawg Status
Medasin - Everytime
Huron John - Andy
Hamilton Leithauser - Isabella
Overcoats - New Shoes
MORGAN - My Year
Rexx Life Raj - Rose Bowl
NoCap - Stop Spinnin
CJ Fly - I TRIED (feat. OSHUN)
Jutes - Where Are You Going
Asking Alexandria - Antisocialist
Grouplove - Youth
Cyn - Drinks - From "Promising Young Woman" Soundtrack
Kodaline - Sometimes
Brandy Clark - Pawn Shop
[Saint Sister - Dynamite] üêö
Millie Turner - Jungle
White Panda - Somebody Loves You
VAVO - Day N' Night
Carlos Vives - No Te Vayas

[Yung Mal - Shut Up (feat. Lil Keed & Lil Gotit)] üêö
[LBS Kee'vin - Upper Hand] üêö
[DonMonique - Givin' Body] üêö
Xavier Weeks - No Go
Johan Lenox - i need a vacation
[Daniyel - SCARRED UP] üêö
Peach Pit - Black Licorice
Caro - the first one
John Newman - Stand By Me
Lauren Auder - the shepherdEmbed