New Music Friday 04/20/18 LyricsAriana Grande - No Tears Left To Cry
Khalid, 6LACK & Ty Dolla $ign - OTW
J. Cole - 1985 (Intro to “The Fall Off”)
Anne-Marie - 2002
Liam Payne & J Balvin - Familiar
The Chainsmokers - Somebody feat. Drew Love
BURNS - Hands On Me feat. Maluma & Rae Sremmurd
Billie Eilish & Khalid - lovely
Lykke Li - hard rain
Lord Huron - Never Ever
Sugarland - Babe feat. Taylor Swift
Gryffin - Winnebago feat. Quinn XCII & Daniel Wilson
Russ - Basement feat. Jessie Reyez
Jeremy Zucker & Chelsea Cutler - better off
Rae Sremmurd, Swae Lee & Slim Jxmmi - CLOSE feat. Travis Scott
Lucas Nord - Care Enough
Seeb - Nice To Meet You feat. Goodito Frito
6 Dogs - Off the Gas feat. Lil Skies
Prince - Nothing Compares 2 U
Poo Bear - Perdido feat. J Balvin
Wiz Khalifa - 420 Freestyle
BlocBoy JB - Produced by Blocboy
AURORA - Queendom
Off Bloom - Love Actually
Shaé Jacobs - Space
Yk Osiris - Valentine
Naaz - As Fun
Two Feet - Same Old Song (S.O.S. Part 1)
A Boogie Wit da Hoodie - Best Friend feat. Tory Lanez
Miguel - Sky Walker (Recorded at Spotify Studios NYC)
Malia Civetz - Little Victories
Pete Yorn - Bad Dreams feat. Scarlett Johansson
VanJess - Addicted
Leon Bridges - Beyond
Janelle Monáe - I Like That
Flosstradamus - MVP feat. Smokepurpp
KiLL edward - Tidal Wave (just a little reference)
Father John Misty - Disappointing Diamonds Are the Rarest of Them All
Bishop Briggs - Lyin'
PRETTYMUCH - On My Way
More Giraffes - Dinosaur
Courtney Barnett - City Looks Pretty
Lemaitre & Jerry Folk - Control
Wild Culture & Qveen Herby - Love Myself
Damian Marley - Medication (Remix) feat. Stephen Marley, Wiz Khalifa, Ty Dolla $ign
Cam - Palace (Cover)
Halsey - Alone (Calvin Harris Remix) feat. Stefflon Don
Mahalia - No Reply
Tokyo Police Club - New Blues
Morgan Wallen - Had Me By Halftime
Martin Garrix & LOOPERS - Game Over
CRUISR - Mind Eraser
VHS Collection - One
The Longshot - Kill Your Friends
Casey Veggies - Show Off feat. Wiz Khalifa
A Perfect Circle - So Long, And Thanks For All The Fish
Andy Jenkins - Sweet Bunch feat. Matthew E. White
L.I.F.T - WANNA DIE
Channel Tres - Controller
Confetti - When I Grow Up
Hobo Johnson - Peach Scone
Hyphen Hyphen - KND
MorMor - Whatever Comes to Mind
Chad Valley - See-Through
Jack & Jack - Stay With Me
Schilly - Higher feat. Nessly
ALLBLACK - Road Run feat. Shoreline Mafia
Becky G & Natti Natasha - Sin Pijama
Jim James - Just A Fool
Yuno - Why For
IZNiiK - round the world
Dijon - Skin
Novo Amor - State Lines
Bahari - Savage
The Paper Kites - On the Train Ride Home
JGrrey - Growing
Vacationer - Being Here
Naughty Boy - All Or Nothing feat. RAY BLK & Wyclef Jean
Anna Leone - Wandered Away
Deafheaven - Honeycomb1Embed