New Music Friday 2/14/20 LyricsBillie Eilish - No Time To Die
Justin Bieber - Forever (feat. Post Malone & Clever)
Sam‚ÄÖSmith‚ÄÖ- To Die‚ÄÖFor
A Boogie Wit da Hoodie -‚ÄÖNumbers (feat. Roddy Ricch, Gunna and London On Da Track)
Migos - Give No Fxk
Tame Impala - Breathe Deeper
Alec Benjamin - Oh My God
Justin Bieber - Second Emotion (feat. Travis Scott)
YG - Konclusions
Bad Bunny - Ignorantes
Madison Beer - Selfish
Powfu - death bed (feat. beabadoobee)
Melanie Martinez - Copy Cat (feat. Tierra Whack)
A Boogie Wit da Hoodie - Might Not Give Up (feat. Young Thug)
Yung Gravy - Bandsville
The Strokes - At The Door
Grimes - Delete Forever
Jean Dawson - BRUISEBOY
Kim Petras - Reminds Me
MEDUZA - Born To Love (feat. SHELLS)
Ozuna - 100 Preguntas
Polo G - Go Stupid
YoungBoy Never Broke Again - Knocked Off
Monsta X - YOU CAN'T HOLD MY HEART
Sabrina Carpenter - Honeymoon Fades
Lennon Stella - Golf On TV feat. JP Saxe
Shallou - Forget
Arlo Parks - Eugene
King Princess - Ohio
Luke Bryan - Born Here Live Here Die Here
HRVY - ME BECAUSE OF YOU
EDEN - how to sleep
Kodak Black - Because Of You
Pop Smoke - Wolves (with NAV)
Calboy - Barbarian (feat. Lil Tjay)
lilspirit - back to life
Dounia - Mars or Maui
Sj - Heaven
Sam Fender - Hold Out
AJR - Bang!
Alexander 23 - I Hate You So Much
Black Atlass - Lie To Me
PnB Rock - Ordinary (feat. Pop Smoke)
G Herbo - In This Bitch
Aloe Blacc - I Do
Sofia Reyes - IDIOTA
Stephanie Poetri - Do You Love Me
Loud Luxury - Cold Feet
Fetty Wap - Reasons
JUMEX - XOXO
Casanova - D&D feat. Fivio Foreign & Smoove'L
LightSkinKeisha - Spend Sum Cash
UMI - Picture Perfect
Beach Bunny - April
Cavetown - Sweet Tooth
COIN - Valentine
Russell Dickerson - Love You Like I Used To
Carly Pearce - Finish Your Sentences
Beulahbelle - Raleigh
New Hope Club - Why Oh Why
DreamDoll - Who You Loving? (feat. G-Eazy & Rahky)
Luh Kel - Y.O.U.
Flo Milli - My Attitude
Rauw Alejandro - Tattoo
DRAMA - Forever and a Day
Ryann - Drive
Cameron Dallas - Helpless
Yung Pinch - Number 1
Elliot Lee - Pink (Freak)
Chaz Cardigan - Being Human
Cold War Kids - Who‚Äôs Gonna Love Me Now
You Me At Six - Our House (The Mess We Made)
$uicideBoy$ - All Dogs Go To Heaven
Ace Hood - Big Fish
Raissa - VALENTINE
[DJ D-Sol - Electric (feat. Hayley May)] üêö
Chloe Angelides - Ex Wifi
Cailin Russo - You Touch Me, I Touch You Back
Cam - Till There's Nothing Left
Ingrid Andress - Life of the Party
Jason Isbell and the 400 Unit - Be Afraid
TOPS - Witching Hour
Tennis - Matrimony II
Kota the Friend - Monday
Lil Keed - Drip Jacker NOTE
[Marlo - Lit AF] üêö
Boosie Badazz - One of Them Days Again
Childish Major - Shallow Dimes
WENS - Beauty Queen
Cast of Zoey‚Äôs Extraordinary Playlist - Help!
Christian Paul - Maria
Spencer. - 2much
Tink - Cut It Out
IV Jay - Love Song

[Jalen Santoy - Something Different] üêö
[Renni Rucci - Bitch Do It] üêö
Matt Simons - Cold
GG Magree - You Don't Know Me
Terrace Martin - LiesEmbed