New Music Friday 1/03/20 LyricsJustin Bieber - Yummy
Lauv - Changes
Lil Tjay - 20/20
Ava Max - On Somebody
Hailee Steinfeld - Wrong Direction
Sam Hunt - Sinning With You
Why Don't We - Chills
Moneybagg Yo - U Played (feat. Lil Baby)
Yung Pinch - Beach Ballin' (feat. blackbear)
Gabrielle Aplin - Miss You 2
Julie Bergan - Kiss Somebody (with Seeb)
Oh Wonder - Happy
Bombay Bicycle Club - I Can Hardly Speak
Lane 8 - Just
Verzache - Talk
Quando Rondo - Bad Vibe (feat. A Boogie Wit da Hoodie & 2 Chainz)
Morgan Wallen - This Bar
Carly Pearce - Call Me
guardin - backup
Olivia Rodrigo - Just for a Moment - From "High School Musical: The Musical: The Series"
Princesa Alba - Mi Culpa
Camden Cox - Healing
Amtrac - Radical
lil Tr33zy - Wolf
Salaam Remi - One Time
No Love For The Middle Child - No Sleep
RAT BOY - VICTIM OF A SYSTEM
MIST - Savage
Cienfue - On the Back of Your Neck
The Mowgli's - Wasting Time
No Friends - Dangerous
Eric Bellinger - Build Something
Myke Towers - La Playa - Remix
Hannah Grace - When I Ruled the World
Wild Nothing - Foyer
COUNTERFEIT. - The New Insane
JUNG - Call Me Up
WILD - This Is Our Time
REYKO - Surrender
EDEN KAI - Outside Inside
David Bisbal - En Tus Planes
Superheart - World's on Fire
Brett Kissel - She Drives Me Crazy
Set It Off - So Predictable
Devon Gilfillian - Stay A Little Longer
prettyboyshav - supernova
DigDat - 8 Style II
Trove - Cyclone
Jonah Baker - If You Don't
Yung Scuff - U DO UEmbed