New Music Friday 03/18/22 LyricsJuice WRLD - Sometimes
Charli XCX - Used To Know Me
ROSAL√çA - CANDY
Normani - Fair
Arcade Fire - The Lightning II
Machine Gun Kelly - maybe (feat. Bring Me The Horizon)
Carrie Underwood - Ghost Story
Still Woozy - Pool
Lil Durk - Computer Murderers
Coi Leray - Blick Blick (with Nicki Minaj)
Joel Corry - What Would You Do?
Blessd - Tendencia Global
Fivio Foreign - Magic City (feat. Quavo)
Ethan Gruska - So Unimportant
GAYLE - luv starved
Zoe Wees - Lonely
Sasha Alex Sloan - WTF
Syd - CYBAH (feat. Lucky Daye)
Nigo - Heavy (with Lil Uzi Vert)
BoyWithUke - IDGAF (with blackbear)
Mabel - Good Luck
Tones And I - Eyes Don‚Äôt Lie
King Princess - For My Friends
Princ–µss Nokia - No Effort
ArrDee - Early Hours
KennyHoopla - DIRTY WHITE VANS//
Weezer - A Little Bit of Lov–µ
Elle King - Out Yonder
MUNA - Anything But Me
Sudan Archives - Home Maker (Edit)
Doechii - Persuasive
Key Glock - Play For Keeps
SSGKobe - ESCAPE YOUR LOVE (feat. Trippie Redd)
Robinson - Ayo Girl (Fayahh Beat) (feat. Rema)
Becky Hill - Personally
Julia Wolf - R.I.P. to the Club
Tom Grennan - Remind Me
Tom Morello - Come On Up To The House (feat. X Ambassadors) - Spotify Singles
Muse - Compliance
NGHTMRE - Fall Into Me (feat. Dylan Matthew)
Joyce Wrice - Iced Tea
Elaine - Shine
Mahalia - Whatever Simon Says
Jake Scott - Texas Girl
Hailey Whitters - Big Family
Cami - EL PEOR
Midwxst - step back
Smiley - Bill
The Smile - Skrting On The Surface
HEALTH - STILL BREATHING
Yot Club - u dont kno me
Devon Again - All My Fault
Peter McPoland - Let Her Remember
B√ºlow - Playin' Me Back
Bailey Bryan - MF (feat. 24kGoldn)
Capella Grey - Confujawn (feat. Nija)
NoCap - Shackles to Diamonds
Sada Baby - Bop Stick
Ethel Cain - Gibson Girl
Hovvdy - Everything
Ruby Red - Too Late (To Call)
Elohim - Talking to Myself
Sam Tompkins - My Brother
Mt. Joy - Lemon Tree
Lucius - Dance Around It (feat. Brandi Carlile & Sheryl Crow)
Walk Off the Earth - Bet On Me
Tiana Major9 - On God!
Teriyaki Boyz - Mor√´ Tonight (with Nigo)
Dreamer Boy - OVER EVERYTHING
Matt Maltese - Smile in the Face of the Devil
Zach Hood - never knew a heart could break itself
Lauren Weintraub - Missing You
The Score - Fighter
Stray Kids - MANIAC
VOIL√Ä - Imaginary Friends
KiD RAiN - I Hope You Never Fall in Love Again
Yaya Bey - keisha üïí
Malik Moses - Marvin - A COLORS SHOW
Sam James - Going Through It (feat. Moneybagg Yo, NoCap)
Leikeli47 - LL Cool J
Yvngxchris - excuse me?
Kungs - People (with The Knocks)
Lights - In My Head (ft. Josh Dun)
Stephanie Poetri - Bad Haircut (feat. JVKE)
T'neeya - COMING
Saya Gray - IF THERE‚ÄôS NO SEAT IN THE SKY (WILL YOU FORGIVE ME???)
Col3trane - Plus Minus (with Erick the Architect)
Creative Culture Co. - Be Ok üïí
GRIP - Dirty Work
Lil Poppa - The Wire (feat. Jdot Breezy) üïí
Natanael Cano - De A De Veras
Deanna Petcoff - If You Were Me üïí
The Let Go - Beabadoobee
Haiden - Sorry to Your Next Ex
Kate York - Life's Just Begun
Karlae - Did That
North Ave Jax - 2 High 2 Speak
Alessia De Gasperis - When You Love Someone
TAYA - For All My Life
Sarah Silva - Cumbia LocaYou might also likeEmbed