New Music Friday 11/06/20 LyricsTRAGIC (feat. Youngboy Never Broke Again & Internet Money) - The Kid LAROI
Young Wheezy (with Gunna) - NAV
Mood (Remix) feat. Justin Bieber, J Balvin & iann dior - 24kGoldn
What That Speed Bout!? - Mike WiLL Made-It
La Luz - Sech
Hawái - Remix - Maluma
Bryson - NLE Choppa
Krabby Step (with Tyga & Lil Mosey) - Music From "Sponge On The Run" Movie - Swae Lee
Columbia - AG Club
Happen To Me - BENEE
Remember That Night? - Sara Kays
For Ya - Paloma Mami
thingsudo2me - ericdoa
Make U Stay - Sega Bodega
Days Like This - Dermot Kennedy
Protect The Land - System Of A Down
Quarantine Thick - 2 Chainz
FOOL'S GOLD - Aries
What a Time To Be Alive (feat. Pink Sweat$) - Amy Allen
Edge of Midnight (Midnight Sky Remix) (feat. Stevie Nicks) - Miley Cyrus
Headstart - Jade Bird
Where I’m From (feat. Wiz Khalifa) - Lukas Graham
Confetti - Little Mix
I Admit It (feat. 24kGoldn) - ZHU
Mountains - Lost Kings
Minefields - Faouzia
Free Woo - 42 Dugg
LOVELIFE (with Jeremih) - Benny Benassi
Love Of Your Life - RAYE
hurts 2 hate somebody - ELIO
You'll Never Walk Alone - Brittany Howard
On Fleek (feat. Gunna) - Yella Beezy
Good Evening - Shordie Shordie
This Weekend (feat. Ty Dolla $ign) - Phora
favorite color - contradash
Misfit - Evie Irie
Real Groove - Kylie Minogue
Washed Up - Cheat Codes
Buff Baddies - Giggs
Damn (feat. 6lack) - Omah Lay
Stop Calling The Police On Me - Serena Isioma
look up - Joy Oladokun
Antidote to Being Bored - Oscar Lang
Honey - Rook Monroe
We Used To - Donovan Woods
Close Enough - Seaforth
Rest Of My Life - JC Stewart
Set Me Free (feat. MAX) - Oliver Heldens
Middle Of The Night - Ninajirachi
Love Bites - Master Peace
Own My Masters - Jackboy
Nekkid - Muni Long
Cheat - LunchMoney Lewis
JUMPIN (feat. MILES) - Jake Miller
dependent - Mae Muller
First Time - Savannah Cristina
Yesterday (feat. Trippie Redd) - Doe Boy
Bratz Doll - XIX
Love Killa - Monsta X
Feel Something (feat. Duncan Laurence) - Armin van Buuren
Tú Me Dejaste De Querer (feat. Niño de Elche & La Hungara) - C. Tangana
Fearless - Łaszewo
My Side - Rocci
No Evidence - Dee Watkins
Back In Blood (feat. Lil Durk) - Pooh Shiesty
Light Up - Vivian Green
Everybody's Lost - Ananya Birla
True Crime - DREAMERS
Nothing Like a Love Song - Hanson
Gone - James Vincent McMorrow
on ur mind - lentra
L.A. Times (feat. REASON) - Nana
Conceited - LBS Kee'vin
ATM (feat. Missy Elliott) - Bree Runway
VILLAIN - K/DA
Now - Adam K
Want Me - Baby Queen
Birdcage - Novo Amor
The Hard Way - FRANKIE
I Should Be Asleep - Ian McConnell
Never Really Gone - Spencer Crandall
Canyons - Live - Cory Asbury
Go Live (with YG) - Mitch
IDC (feat. Trippie Redd) - D Savage
Heart Right - Slatt Zy
Off the Lead - Working On Dying
I Wonder - Sally Boy
I Wonder - Ella Grace
The Bottom Line - Ólafur Arnalds
Better - SEU Worship
There Will Be a Way - Dotan
Young - Rudie Edwards
Arizona Summer - Peter Fenn
L.O.O.K. - Guap Tarantino
FAST - ANNA
IOU (feat. Guapdad 4000) - Emalia
an evil witches love spell - Lil Boom
Time & Space - Yo Trane
‎friends /‎ wasted - maxime.
Just Like A River Does - Birdy
This Land is Your Land - Woody GuthrieEmbed