New Music Friday 10/25/19 LyricsSelena Gomez - Lose You To Love Me
Selena Gomez - Look At Her Now
Coldplay - Orphans
Tyga, YG & Santana - MAMACITA
Major Lazer - Trigger
Frank Ocean - DHL
The 1975 - Frail State Of Mind
Kesha - Raising Hell (feat. Big Freedia)
Gryffin - Need Your Love (with Noah Kahan)
Logic - OCD (ft. Dwn2earth)
Rex Orange County - Face To Face
Lizzo - Good As Hell (feat. Ariana Grande) - Remix
XXXTENTACION - HEARTEATER
Roddy Ricch - Start Wit Me (feat. Gunna)
Victoria Monét - Ass Like That
King Princess - If You Think It's Love
Mumford & Sons - Blind Leading The Blind
Galantis - Faith (with Dolly Parton) [feat. Mr. Probz]
Lunay - Aventura
Megan Thee Stallion - Ride Or Die - From "Queen & Slim: The Soundtrack"
iann dior - Strings
Gracie Abrams - Mean It
Conan Gray - Maniac
Cigarettes After Sex - Touch
Doja Cat - Rules
Kodak Black - Zombie (feat. NLE Choppa & DB Omerta)
Anitta - Pantera - From "Charlie's Angels (Original Motion Picture Soundtrack)"
Alexander 23 - The Internet
Spencer Barnett - Waste My Time
Luke Bryan - What She Wants Tonight
Louis Tomlinson - We Made It
Gallant - Sweet Insomnia (feat. 6LACK)
Quin Nfn - Poles
SONIA - Games
Lost Kings - Feather (feat. Finn Askew)
R3HAB - All Comes Back To You
Favian Lovo - Los Puti (with Lele Pons & Lyanno)
Walk Off the Earth - Addicted
Why Don't We - Mad At You
Old Dominion - Paint the Grass Green
Mondo Cozmo - Come On
Anna of the North - My Love
Jake Scott - Favorite T-Shirt
PRETTYMUCH - Me Necesita
Luke James - Go Girl
Skizzy Mars - Leave Me (feat. Marc E. Bassy)
Mura Masa - No Hope Generation
Jack Larsen - Bubba
Tinashe - Die A Little Bit
Luh Kel - Movie (feat. PnB Rock)
9lokknine - Trap Do (feat. Rich The Kid)
Queen Naija - Good Morning Text
Låpsley - My Love Was Like the Rain
CXLOE - Devil You Don't
Leyla Blue - What A Shame
Guapdad 4000 - Stuck With It (feat. Tory Lanez)
O.T. Genasis - Big Shot (feat. Mustard)
DaVido - Risky
JP Cooper - The Reason Why
James Blunt - The Truth
Lady Antebellum - What I’m Leaving For
Gabrielle Aplin - Like You Say You Do
UMI - Runnin'
K. Michelle - The Rain
Dave East - Godfather 4
Jackson Wang - TITANIC (feat. Rich Brian)
Goth Babe - Her Vacation
Jax Anderson - Scared To Death
Banoffee - Tennis Fan
Lil Zay Osama - Percocet Crazy
Wynne - Fine Things
EDEN - projector
DeathbyRomy - Let Me Fall
Highly Suspect - Canals
Stafford Brothers - Spray Champagne
Smino - Trina
VOILÀ - Déjà Vu
Claud - Just To Forget
Jelani Aryeh - Earl Grey
Tessa Violet - Words Ain't Enough
Aaron Carpenter - No Control
Anthony Ramos - Relationship
Danny Ocean - Dime tú
Justin Rarri - MORE THAN BESTFRIENDS
Daniela Andrade - Tamale
Frances Quinlan - Rare Thing
Duncan Laurence - Love Don’t Hate It
La Doña - Le Lo Lai
PVRIS - Old Wounds
Bad Wolves - Better Off This Way
Donna Missal - You Burned Me
Dounia - SPOOKY SZN
Tank - Somebody Else (feat. JoJo)
Jonah Mutono - Shoulders
Eddie Zuko - Mijo
Ashnikko - Halloweenie II: Pumpkin SpiceEmbed