New Music Friday 5/28/21 LyricsJuice WRLD - 734
Bad Bunny - 100 MILLONES
Culture Jam - Everything Different
Griff - One Foot in Front of the Other
Mustafa - The Hearse
J Balvin - Qué Más Pues?
DMX - Bath Salts (feat. JAY-Z & Nas)
Tate McRae - Darkest Hour - from the Amazon Original Series PANIC
Sam Feldt - Pick Me Up
ericdoa - fantasize
Oliver Tree - Life Goes On
Marshmello - Back In Time
Sleepy Hallow - Mi No Sabe
Swae Lee - Forever Never (feat. Swae Lee & Pink Sweat$)
Russ - Private
88rising - California (feat. Warren Hue)
AUDREY NUNA - That XX - Spotify Singles
Sigrid - Mirror
Dynoro - Monstеrs (feat. 24kGoldn)
Master KG - Shine Your Light (fеat. Akon)
Nicky Jam - Pikete
Hotboii - Nobody Special (with Future)
Cochise - Tell Em
Peter McPoland - i can't sleep
Audrey Mika - Alive
yaeow - how to live
Prentiss - i'll do it again
MØ - Live to Survive
Aya Nakamura - Bobo
Destiny Rogers - West Like (feat. Kalan.FrFr)
Blxst - Movie
Lil Gotit - Work Out
Mereba - Go(I)d
Jonas Blue - Hear Me Say
Lost Kings - I Miss The Future
Nessa Barrett - I'm Dead (feat. jxdn) [From the Podcast “Prom In Hell”]
Marc E. Bassy - Trouble
Chase Rice - The Nights
JoJo - Creature of Habit
Q - Want
gabriel black - batman
JAWNY - Take It Back
Yola - Stand For Myself
Sofi Tukker - Mon Cheri
DRAMA - Don't Hold Back
easy life - ocean view
whiterosemoxie - Beeline
Blueface - Patience 🐚
Jelly - In and Out 🐚
박혜진 Park Hye Jin - Y DON'T U 🕒
Dora Jar - Polly
Hong Kong Boyfriend - see u dance 🕒
Jake Cornell - tmrw
half•alive - TIME 2
Robyn Ottolini - Tell You Everything
Foy Vance - Sapling
Gabrielle Current - Make It Right
Njomza - over and done
Wrabel - nothing but the love
ONE OK ROCK - Broken Heart of Gold
Natalia Lafourcade - Nada Es Verdad
DaBaby - Get Fly (feat. DaBaby)
Larry June - You Gotta 🕒
Tone Stith - Like The First Time
Symphani Soto - Just A Moment
Anna Sofia - Eat It All Up
Kat Cunning - Boys
Ryan Caraveo - No Fun
Kidd G - Break Up Song 🕒
LiL Lotus - Romantic Disaster (feat. Chrissy Costanza)
The Glorious Sons - Young King
Blackberry Smoke - All over the Road
Brynn Cartelli - Jane
Bachelor - Back of My Hand
Tom Odell - lose you again
Cola Boyy - Don't Forget Your Neighborhood
VINCINT - Kill My Heart (feat. Parson James & Qveen Herby)
Darin - Can't Stay Away
Slimelife Shawty - Baby Boy
KILLY - MOONWALK (feat. Yung Bans)
Sage Charmaine - Always Drowning
Victoria Justice - Too F*ckin' Nice
almost monday - this is growing up
Picture This - If Ever However Whenever Forever
Natanael Cano - Diamantes
Lenny Tavárez - Lo Tengo Todo
Asiahn - OMW
YSN Flow - Pac-Man
BigKayBeezy - Killumbus 🕒
LBS Kee'vin - Spaghetti 🕒
Alice Longyu Gao - LEGEND
Sipho. - BODIES
The Wombats - Method To The Madness
JDM Global - Tide
Sarah Barrios - IH8EVERY1
Travis Thompson - Crossfaded
Fire In Little Africa - Elevator - Fire in Little Africa, Hakeem Eli'juwon & Steph Simon 🕒
Aaron Cole - MIRACLE
Tamera - Wickedest
Wifisfuneral - CC Demon (with jetsonmade)Embed