October 2022 Singles Release Calendar Lyrics10/1
DRAM - "Let Me See Your Phone"
Shawn Christmas - "Same Mistakes"
10/3
Fred again.. - "Kammy (like i do)"
馮允謙 (Jay Fung) - "Take A Breath"
NateWantsToBattle - "Nothing Left to Want"
10/4
Lil Yachty - "Poland"
Ozuna - "Te Pienso"
Tee Grizzley - "Tez & Tone 1"
10/5
3Breezy - "All Of Me"
bbno$ - "top gun"
Emily Scott Robinson - "Double Double" ft. Alisa Amador & Violet Bell
​girlpuppy - "Teenage Dream"
Gryffin & Tinashe - "Scandalous"
Jordan Ward & Joony - "IDC"
Nippa - "Where They At"
Ritchy 31 - "All In"
Ty Dolla $ign & Mustard - "My Friends" ft. Lil Durk

10/6
Connie Constance - "Hurt You"
daine - "stay close"
Jowell & Randy - "TORO"
Justin Quiles & Carin León - "La Esquina del Mall"
L'Impératrice & Rejjie Snow - "Everything Eventually Ends"
Nicki Minaj & Skeng - "Likkle Miss (The Fine Nine Remix)" ft. Spice, Destra Garcia, Patrice Roberts, Lady Leshurr, Pamputtae, Dovey Magnum, Lisa Mercedez & London Hill
Paulina Rubio - "Me Gusta" ft. Maffio
Seven Kayne - "Ordené Mi Cuarto 2.0"
Sylvie - "Further Down the Road" ft. Marina Allen
Tion Wayne - "Let's Go" ft. Aitch
TOBi - "Flowers"
Triple G - "岸 (Shore)"
10/7
A Boogie wit da Hoodie - "B.R.O. (Better Ride Out)" ft. Roddy Ricch
ACRAZE - "Believe" ft. Goodboys
Adam Lambert - "Mad About the Boy"
Addison Grace - "Pretty Girl"
All Time Low - "Sleepwalking"
Almighty Jay - "Bottle Girls" ft. Polo G
Alok, Sigala & Ellie Goulding - "All By Myself"
Amy Shark - "Only Wanna Be With You"
Brevin Kim - "THE PPL I'VE BEEN"
BRS Kash & North Ave Jax - "Rich & Famous"
Carly Rae Jepsen - "The Loneliest Time" ft. Rufus Wainwright
Cat Burns - "people pleaser"
Cat Burns - "sleep at night"
Elaine - "Fading Away"
F.N. - "Must Be Nice"
FEYZAL - "​On the Road"
Findlay - "Better Now"
Flame Princess - "When U Look"
Flwr Chyld & Flozigg - "Worth It"
Forest Blakk - "I Remember"
Gabrielle Aplin - "Never Be the Same"
GOON DES GARCONS* - "answer"
Gracie Abrams - "Difficult"
Grey Zeigler - "numb"
Hoosh & Paperwater - "Slow Dance"
Hozier - "Swan Upon Leda"
INNA, MELON & Dance Fruits Music - "Hello Hello"
Jake Scott - "Good Day"
Jazmine Sullivan - "Stand Up"
Kali Uchis - "La Única"
Kathleen - "Beautiful Waters"
Kay Flock - "Geeked Up" ft. Gucci Mane
謝安琪 (Kay Tse) - "我的波利海妮婭 (My Polyhymnia)"
Kiana Ledé & Cautious Clay - "Who Do You Think You Are"
Kordhell & Scarlxrd & CORPSE - LIKE YXU WXULD KNXW (AUTUMN TREES)
Lil Rubbi - "Black Hearted"
Lily Rose - "Whatcha Know About That"
Lou Phelps - "Out My Face"
Maisie Peters - "Not Another Rockstar"
Max Drazen - "Blurry Pictures"
​Mickey Guyton - "How You Love Someone"
Mimi Webb - "Ghost Of You"
Nessa Barrett - "tired of california"
NLE Choppa - "Do It Again" ft. 2Rare
Noizy, Capo Plaza & Krept & Konan - "Big Budz No Dust"
Olivia Lane - "Wherever You Are"
RealestK - "Trust"
RINI - "Selfish" ft. BEAM
Sadie Jean - "Locksmith"
Scotty Sire - "LEAVE ME ALONE"
SipTee - "On 10" ft. EST Gee
Sorana - "Happy Birthday Sadness"
SwaVay - "GO SHORTY"
Tiësto & Black Eyed Peas - "Pump It Louder"
Torine - "bitches get lonely"
Tyga - "Booty Dancer"
Unlike Pluto - "Best at Being the Worst"
10/8
DAGames - "Green: SSD"
10/10
Bobby Fishscale - "MADE IT"
Doechii - "Stressed - A COLORS SHOW"
鄭欣宜 (Joyce Cheng) - "Glitterfalls Part 2"
MIRROR - "We All Are"
藍奕邦 & 鄧小巧 (Pong Nan & Tang Siu Hau) - "自知之明 (Self Aware)"
The Hertz - "末世情書 (To Whom It May Concern)"
泳兒 (Vincy Chan) - "Little fires everywhere"
10/11
Andy Lai - "To Go"
IShowSpeed - "Trip to Brazil" ft. Bandmanrill
Jordin Sparks & Th3rdstream - "What Are We Fighting For"
Kx5 - "Alive" ft. The Moth & The Flame
陳健安 (On Chan) - "厭惡物圖鑑 (Your Catalogue Of My Disgrace)"
Qveen Herby - "5D"
Qveen Herby - "DRESS CODE"
Tee Grizzley - "Jay & Twan 2"
10/12
bbno$ - "i see london i see france"
Eli Derby - "Recognize"
KELZ - "Why"
Phora - "Euphoria"
Phora - "Late At Night"
RAYE - "Escapism" ft. 070 Shake
RAYE - "The Thrill Is Gone"
10/13
A1 x J1 & Nemzzz - "Don’t Lie"
Chesca, Corina Smith & Villano Antillano - "ACTIVA"
Kiri T - "扭擰雪糕屋 (Twist Cone)"
Negro Dub, L-Gante & El Baroja - "Salimos de Noche"
NSG & Giggs - "Nyash"
Tom Walker - "The Best Is Yet To Come"
Zenzei - "Manipuladora"
10/14
44phantom - "Hurricane"
Alexander 23 - "​ill" ft. Kenny Beats
AViVA - "OBLIVION"
Big Boss Vette - "Pretty Girls Walk"
Blake Rose - "Dizzy"
Boyce Avenue & Rachel Grae - "Let It Go"
blink-182 - "EDGING"
Brenda Lee - "Rockin’ Around The Christmas Tree (Reimagined By Filous)"
Briston Maroney "Harvard"
Briston Maroney "Oregon"
Bruce Springsteen - "Nightshift"
ceo@business.net - "circus" ft. jungle bobby
CHASE WRIGHT - "Hurt No More"
Christian Leave - "Pull"
Corey Kent - "How You Know You Made It"
Cyn - "Losing Sleep"
Doechii - "Stressed"
ELENA ROSE, Greeicy, & María Becerra - "La Ducha (Remix)" ft. Becky G, TINI
Emotional Oranges - "Petty"
Ethan Bortnick - "arsonists"
Fly By Midnight - "Sometimes"
Gaidaa - "Figures"
girl in red - "October Passed Me By"
GOON DES GARCONS* - "​the things (it in itself)"
Jacob Latimore - "Selfish"
Jae Lynx & Zazu Babii - "Punish It" ft. Kenzo Balla
Jordana Bryant - "Bad Relationships"
Kenzo B - "Make It Lit"
Leah Kate - "Hot All The Time"
Lila Drew - "Lila’s Theme"
Lil Xxel - "No One But Me"
Louis Tomlinson - "Out Of My System"
Lous and The Yakuza - "Hiroshima"
Madison Beer - "Showed Me (How I Fell In Love With You)"
Marshmello & Juice WRLD - "Bye Bye"
Mellow Rackz - "Rich Bitch Party"
Mitch James - "japan"
Mora - "Como Antes"
MUST DIE! - "KEEP U SAFE"
Nico Santos - "One Day (I’m Gonna Break Your Heart)"
Pink Sweat$ - "Lay Up N' Chill" ft. A Boogie wit da Hoodie
Prentiss & ​lil aaron - "​seasons"
RealestK - "I Think I Do"
Robbie Meza - "No Le Creo" ft. Manu Manzo, Yetsi
Rowan Drake - "Hey Little Sister"
Russ - "BET"
Russell Dickerson - "Big Wheels"
Shaylen - "Roots"
STANY, Rema & Offset - "Only You"
Stormzy - "Hide & Seek"
Tenille Arts - "Jealous of Myself"
The Stupendium - "What a Plunderful World"
Tiara Thomas - "Don't Talk Back"
Unlike Pluto - "Intoxicate Me"
Walker Hayes & Ciara - "Y'all Life"
Zack Tabudlo - "Take Me Back"
10/15
DAGames - "Cup de Grâce" ft. Cosmic Keyframe

10/17
BiC Fizzle - "Chief"
Big Scarr - "Understanding"
Caroline Polachek - "Sunset"
Enchanting & Gucci Mane - "Issa Photoshoot"
洪嘉豪 (Hung Kaho) - "活誰的命 (Twisted Fate)"
Lil Uzi Vert - "Just Wanna Rock"
10/18
Baby Rose - "Fight Club" ft. Georgia Anne Muldrow
古巨基 & 葉巧琳 (Leo Ku & Mischa Ip) - "樓下有人 (Someone Downstairs)"
10/19
bbno$ & Yung Gravy - "touch grass"
陳柏宇 (Jason Chan) - "有天 (Someday)"
Lastlings - "Get What You Want"
Lil Poppa - "STAY LOYAL"
NxWorries - "Where I Go" ft. H.E.R.
Paty B - "BRUTAL"
Shakira & Ozuna - "Monotonía"
Vita Flare - "ALIEN"
10/20
Big Moochie Grape - "Get Money Catch Bodies"
Chris Andrew - "Bien Activá"
Chris Lanzon - "FUCK IT UP!"
Finesse2Tymes - "Humble"
Icewear Vezzo - "God Bless The 6" ft. Babyface Ray
Jhayco, Feid & Sech - "En La De Ella"
Jim Jones & Hitmaka - "Gunshot" ft. BEAM
Joshua Bassett - "i'm sorry"
Kapla y Miky - "Panas" ft. ROBI
Kim Loaiza & Elvis de Yongol - "Devoto"
Lancey Foux - "SPIRIT OF X2C"
Mariah Angeliq & YOVNGCHIMI - "En La Mía"
Martinwhite - "Pitiklein"
Miky Woodz - "Big Booty, Pretty Face"
Nafe Smallz - "Sex On The Moon"
Sound Rush - "Interstellar"
Yandel & Arcángel - "Doxxis"
Yung Ro - "Lit Up"
Yuridia & Ángela Aguilar - "Qué Agonía"
Zarahn - "With You"
10/21
3Breezy & Yatta Bandz - "2Far Gone"
A Boogie wit da Hoodie - "Take Shots" ft. Tory Lanez
Ab-Soul & Zacari - "Do Better"
ADRI - "Claramente"
Allyn - "One Time" ft. DOM KENNEDY
Azanti - "​late4dinner"
Babyface Ray - "Nice Guy"
Ben Kessler - "Default"
Bino Rideaux - "DEAD FACES" ft. Doe Boy
Bishop Briggs - "superhuman"
Blu DeTiger - "Elevator"
Bruello & Princy - "Don't Kill The Vibe" ft. Lil Homie
BSlime - "Bagutte" ft. Persona Jackson
Clean Bandit & Elley Duhé - "Don't Leave Me Lonely"
Coco Jones - "ICU"
David Guetta & MORTEN - "Element"
Dougie B & Yagi B - "Wreck"
​dvsn - "Don’t Take Your Love"
Eric Bellinger - "Obsession"
GALE - "D Pic"
Gareth.T - "笑住喊 (happy tears)"
GOON DES GARCONS* - "makeshift magic" ft. Solo Jaxon
Hybrid Minds & Tom Walker - "Castles"
ili - "2 Cool 2 Be Somebody"
ILLENIUM & MAX - "Worst Day"
Immasoul - "Sugar Boi"
Jack Garratt - "Just How I Like It"
Jeremih - "Changes"
KayCyy - "Breaking Point"
​kenzie - "100 degrees"
Kevtopo - "Si Te Gusto" ft. Andres Melz, Mr Sonic
KREAM - "Rendezvous" ft. Marlo Rex
Lilyisthatyou - "Do I Make You Nervous"
Lul Bob - "Maintain"
Monsieur Nov - "Solo"
逆流 (NiLiu) - "不適 (Discomfort)"
Now United - "All Night Long"
Pabllo Vittar & Gloria Groove - "AMEIANOITE"
Paige - "Miles Away" ft. Ant Saunders
PmBata - "​a letter from Anxiety"
Roddy Ricch - "Aston Martin Truck"
Rosa Linn & Duncan Laurence - "WDIA (Would Do It Again)"
Rileyy Lanez - "4 Life"
Sigrid - "Blue"
Ten - "Searching"
Trevor Daniel - "Karma"
Tyla Yaweh - "Sex Symbol"
vaultboy - "ghost stories"
Ye Ali - "Cam Girl" ft. Damonte
Yungeen Ace - "Industry Invasion"
Zé Felipe - "50 Cópias"
10/25
Chanel - "TOKE"
張蔓姿 (Gigi Cheung) - "自救日常 (Save Myself)"
王嘉儀 (Sophy) - "淹悶 (Boring)"
Levi Roth - "Competition Kissing"
Matt Citron - "Tennessee Thang"
Morray - "Letter To Myself"
Ski Mask the Slump God - "OOGA BOOGA!"
Stiffy & El Virtual - "ViRTUALMENTE"
10/26
Feejoke - "Lolita"
張蔓姿 (Gigi Cheung) - "自救日常 (SAVE MYSELF)"
鄭欣宜 (Joyce Cheng) - "恐懼蠶食心靈 (Fear Eats the Soul)"
古巨基 & 力臻 (Leo Ku & Lagchun) - "Can We Try"
Lil Poppa - "MOTIVATION"
MILKBLOOD - "WATER ME DOWN"
New Hope Club - "L.U.S.H."
New Hope Club - "Walk It Out"
Serrini - "樹仔 (Tree Baby)"
10/27
Abra Cadabra - "Local" ft. Headie One & Bandokay
AK4:20 - "RELAX CON MAX"
Alison Wonderland - "Down The Line"
Call Me Karizma - "Kinda Scary"
Chloe Adams - "Take Me To Hell"
Chris Lebron & Arcángel - "Loco"
Cris Mj & Tiago PZK - "Fiera"
Don Omar & Akon - "Good Girl"
DRAM & BJ The Chicago Kid - "PPL"
Foreign Teck & Anuel AA - "EL NENE"
Indy Yelich - "Killer"
李駿傑 (Jeremy Lee) - "阿波羅 (Apollo)"
Juan Gabriel & Anahí - "Déjame Vivir"
Julia Wolf - "Dracula"
Kapla y Miky - "Flete (Remix)" ft. Pablo Roux, Cervantex & Bery
Maeso - "Viral" ft. Chris Andrew
Manuel Turizo & María Becerra - "Éxtasis"
Metalingüística, Young Miko & Akapellah - "Kachipun"
Morat & Feid - "Salir Con Vida"
Nina Nesbitt - "Need You" ft. Zion Foster
Reik & Rusherking - "A Mi Lado"
Ruel - "Someone Else's Problem"
Sully - "Fall Guy" ft. CG5 & Finn M-K
Yampi & Alejo - "Anatomía"
10/28
Addison Grace - "If Nobody Likes U"
Aleesha - "DIME ALI"
Alicia Keys - "December Back 2 June"
Ashanti - "Falling For You"
Asmir Young - "Inocente"
Black Eyed Peas, Anitta & El Alfa - "SIMPLY THE BEST"
Bob Moses - "Old Love" ft. BROODS
Camylio - "​​amnesia"
Cheat Codes & Jimmie Allen - "Lose You"
Clinton Kane - "Mexico"
Col3trane - "Astrology Joint"
Dove Cameron - "Bad Idea"
Elli Moore - "LEMONADE"
Erick the Architect & AKTHESAVIOR - "No Ice"
Fousheé - "​​supernova"
Gryffin & Elley Duhé - "Forever"
hirsk - "never back down" ft. Matt Force
IDK - "Monsieur Dior"
Juice WRLD - "In My Head"
Kaash Paige - "Doubted Me"
Kenzo B - "Hood Love Story"
Labrinth - "Iridium"
Lauren Jauregui - "Always Love"
Macklemore - "FAITHFUL" ft. NLE Choppa
Mae Muller - "I Just Came To Dance"
Manu Manzo - "Vacío"
Mariah the Scientist - "Bout Mine"
Maya Delilah - "Pretty Face"
MC Buzzz - "Terapia"
Night Lovell - "Eye Spy"
Polo G - "Bag Talk"
Rauw Alejandro - "DIME QUIÉN????"
Rihanna - "Lift Me Up"
RINI - "Haunt Me"
Robin Schulz & Tom Walker - "Sun Will Shine (Acoustic Version)"
Shawn Cristmas - "Rev It Up"
SleazyWorld Go - "Glitches" ft. G Herbo
Stephanie Poetri & gnash - "Breakfast in Bed"
SZA - "Shirt"
Teddy Swims - "Devil In A Dress"
Trey Forever - "ASF"
Trippie Redd & Don Toliver - "Ain’t Safe"
Unlike Pluto - "Supposed to Fall"
Verse Simmonds - "Wide Open"
Y2K - "DIRT" ft. JPEGMAFIA
​Zach Hood - "long distance christmas"
10/31
916frosty - "the fox"
雲浩影 (Cloud Wan) - "氣流 (Flow)"
CY 陳宗澤 (Chase Chan) - "滴滴金 (Fireworks)"
洪嘉豪 (Hung Kaho) - "海邊的呀豪 (Such A Beach)"
陳卓賢 (Ian Chan) - "地球上的最後一朵花 (Last Flower on Earth)"
姜濤 (Keung To) - "無人不知的戰果 (Announcing Victory)"2Embed