August 2022 Singles Release Calendar Lyrics8/1Elias. - "Rearview" ⏳
JohnO & Swoope - "Work Real Hard" feat. Jackie Hill Perry
Kleber Sampaio - "Em nome da Justiça" ⏳
Man0 - "CROSS" feat. Mia Albel ⏳
Ngoga - "POSSIBLE" ⏳
Paper Branches - "From The Lavender Flowers" feat. Ardie Son
Resting Place - "All Hail (Live)" feat. Marissa Rovetto ⏳8/2Alex Jean - "Insecure No More"
Larry Trice Jr - "Sail Away" ⏳8/3CHOICE - "Боже мій" ⏳
igotyourback - "Bloom" feat. Cheon Ju Yeong⏳
Poor Bishop Hooper - "Psalm 136"
The Kid Phxntom - "Stay" ⏳
Wildwood Music - "I Remember"8/4PEDRAZUL - "Amor É Grão" ⏳
Townix - "Tiempo" ⏳
Uninvtd, S A I N T & Young C - "HillSong" ⏳8/5Aaron Sprinkle - "40 Years" ⏳
Abе Parker - "Imposter Syndrome" ⏳
Alvin Cеdric - "Nostalgic"
Amanda Opelt & John Lucas - "Oh Body"
Annatoria - "The Divide" ⏳
Apex Frazier - "Slow It Down" feat. Battz ⏳
Audacious Worship - "Give My All"
Ben Potter - "Yes & Amen"
Bethesda Music & People & Songs - "Wide Eyed Wonder" ⏳
Casting Crowns - "No Hurt"
CastroWorld & LLC Flame - "Church House II" feat. Marc Stevens, Miles Minnick & Mission ⏳
Christian McKinney - "Forever" feat. TyMiracle409
Common Hymnal, Sharon Irving & Vincent Charlow - "Seat At The Table"
Community Music - "Worthy Is Your Name (Exalted) [Live]"
Daniel Lüdtke & Newark Voices - "Brasil pra todo lado" ⏳
Day Three Music & Sanyu Kimuli - "Miracles"
Demon Hunter - "HEAVEN DON'T CRY"
Dreamers - "Keep In Step (Live)" ⏳
Drup - "New Love" ⏳
Elikem Kofi - "So Nice" ⏳
Emilio Sarabia - "JUST POWER" ⏳
Erik Nieder - "Your Glory, My Good"
Esua - "Hidden"
Ethan Nathaniel - "Bonafide" ⏳
Ginny Owens - "Let Us Love" feat. Leslie Jordan ⏳
HNRY - "Fear Be Quiet" feat. Tedashii
Isla Vista Worship - "i'll go"
Jacob Stanifer - "ALL OVER AGAIN"
Jason G Momin - "Still Faithful" ⏳
John Michael Howell - "2009 I Dropped The Ball"
Jonathan McReynolds - "Your World"
Jonathan Traylor - "You Got Me"
Josh Baldwin - "Narrow Road"
Josh Copeland - "Done It For Me" ⏳
Keith & Kristyn Getty & Skye Peterson - "Take Shelter"
Kenny Kore - "Spirit In The Name" ⏳
Kingdmusic - "Protect Me" ⏳
Krissy Nordhoff & Cecily - "Meadow" ⏳
Lakewood Music - "Can I Get An Amen? (Live)" ⏳
Lazarus! - "OTL"
Leah McFall - "Delicate"
Lecrae - "Spread The Opps"
Lizzy Parra & Angel Brown - "Bandera Blanca" ⏳
Loyal Love - "Rest" ⏳
Luke Cyrus & Matthew Parker - "Ninja Archer (Matthew Parker Remix)"
Lwo - "Stevia" ⏳
Matthew Mole - "Goodbye"
Marcelo Sissá - "Um Lugar de Paz"
Mitch Langley - "Ready" ⏳
Morales Smalls - "He Did That" feat. Scootie Wop & Stevie Rizo ⏳
Mosaic MSC - "This Is How I Thank The Lord" feat. Cody Carnes, Amanda Cook & Joe L Barnes
Nathan Sheridan - "Something Worth Singing About" ⏳
Nathan Wagner - "Angels vs Demons"
NCU Worship Live - "Hallelujah to Your Name" feat. Briana Manzari
O'Bros & Laruzo - "U-Turn" ⏳
Pionjär - "Mening"
Red Tips - "Bad Boys"
RELIC - "Ghost" ⏳
Renwick Duesbury - "I Can't Deny" ⏳
Roy Tosh - "Point To You"
Sal Ly & Reblah - "Perfect Love" ⏳
Sam McCabe - "IMPOSTER SYNDROME"
Sammie Ekpoh - "Light" ⏳
S.O. - "THESE DAYS" ⏳
Sorensen - "Loving You"
Sound of Provenance - "This Jar of Clay" ⏳
Strength Betrayed - "SOCIETY" ⏳
Susie Mills - "Does It Haunt You" ⏳
Taylor Tripodi - "Live Wide Open" ⏳
Tehillah Worship - "At the Name of Jesus (Live)" ⏳
Timothy Sharan - "Nalla Pangu"
Tobe Nwigwe - "LORD FORGIVE ME" feat. EARTHGANG, Fat & Pharrell Williams
TobyMac & Jon Reddick - "Show Up Choose Love"
Torey D'Shaun & 1K Phew - "So Good"
Travis Greene & Forward City - "TENT REVIVAL" feat. D'Nar ⏳
Vincent Bohanan & SOV - "Jesus Saved the Day" feat. Bre Holly ⏳
Will Carlisle - "Blood and Bones" ⏳
Will Gray - "Psalm 11"
Worship Awake - "Sing His Name" feat. Stella & Janine Price⏳
Xander Sallows & Ike Smith - "LOSE CONTROL - Ike Smith Remix"
Yadah - "By Yourself" ⏳
Zoe Jean Fowler - "Time Flies"
100graham - "Rooftop"
29:11 Worship - "Living Testimony (Live)" feat. Jaden Moody⏳48/6Caleb Gordon - "Keep It Tucked"
Daniel Paraiso - "Um Pra Sempre Sim" ⏳8/7Lucio Mella - "Pablo y Silas (En Vivo)" ⏳8/8Eliezer de Tarsis - "Esse Deserto Vai Passar" ⏳
Jazelle - "Back To You" ⏳8/9Jeremi Licata - "Open Up" ⏳
Liz Vice - "Promise Land" ⏳
Marty Ray Project & Joshua Sherman - "Jesus, My Reward" ⏳
Sharp Dialect - "Prodigal" ⏳8/10Canto - "Deus Está" ⏳
Isaac - "GRAVEDAD" ⏳
Laura Souguellis - "A Vista Daqui" ⏳
Pembers - "Thinking Of You" ⏳
Rabbi le Prince - "Relève-toi" ⏳8/11Año Cero - "Camino A Casa" ⏳
Marcos Almeida, Paulo Nazareth & Dedê Silva - "Paisagem" feat. Estevão Queiroga ⏳
Mary Ozaraga - "Better Days" ⏳
SIV - "Nothing Left" ⏳
TJ Cream - "The Vibe" ⏳
678NATH - "All Or Nothing" ⏳8/12Abraham Velazquez - "Adán y Eva" feat. Moi ⏳
A-Eazy & Message Muzik - "We Made It" feat. Jon Keith ⏳
A Jesus Church - "Hiding Place" ⏳
Alexander Pappas & Riley Clemmons - "MILLION WAYS"
Alyssa Jordan - "Good Day" ⏳
Amanda Danziger - "Refining Fire" ⏳
Ben Laine - "Trinity"
Blessing Offor - "My Tribe"
Bptheofficial - "Lost Your Way" ⏳
Bradley Kim & ohsobrkn - "myspace" ⏳
Caleb Stanton - "Life Those Days" ⏳
Canyon Worship - "Sometimes" ⏳
Chris Tomlin & Steffany Gretzinger - "O Lord, You're Beautiful"
CieMie - "Wide Awake" feat. Alvin Cedric
Connor Pierson & Brenno - "FEELIN" ⏳
Corey Voss - "As Long As It Takes" feat. Leslie Jordan
David and Kitty McVicker - "Fill Me Up" ⏳
Ed Williams - "Promised" ⏳
Emi Cantú & Merari de la Torre - "Pródigo" ⏳
Emily Brimlow - "Lonely" ⏳
Emily Faith - "Cry" ⏳
Gabriel & Zubi - "i need your protection" ⏳
Gas Street Music & Taku Mudere - "Up To Something (Live)" ⏳
Glochi & Marizu - "Satisfy" ⏳
grantdakidd - "SCARS" ⏳
Icon For Hire - "Shadow"
ISLY - "Feeling Good" ⏳
ISLY - "Good Life" ⏳
Jess Ray - "Place To Land" ⏳
John Michael Howell - "Locket"
Jordan May - "Heart Of Stone" ⏳
Kerrie Roberts - "Make Me Move" ⏳
Kevi Morse - "INTENTIONALITY" feat. Torey D'Shaun ⏳
Kevin Quinn - "More Of You"
KMO Shamaal - "Yahweh" feat. Mike Teezy
Lazarus! - "Lot!" ⏳
Leon Anderson - "Language" ⏳
Likewise Worship - "FOREVER LIFTED HIGH" ⏳
Mac Powell - "You Are" ⏳
Mac Powell - "Savior & Friend" ⏳
Mainetoowavy! - "Connect!" ⏳
Mas - "move" ⏳
Matheus Marotta - "Montanha" ⏳
Matthew West & Anne Wilson - "Me On Your Mind"
Modern Temple - "Going Steady" ⏳
Musumba - "Savages" ⏳
Natural State - "Always Enough" ⏳
Novo Tempo, Rayre Mota & Paula Chacon - "Cuidará Também de Mim" feat. Alisson Melo ⏳
Nu Tone - "His Side" feat. Parris Chariz & Donovan S Davis ⏳
NXTMIKE & TRAPSHIP COLLECTIVE - "ON MY OWN" feat. adriansings, Kip Wolfe, PRESTXN & Setty ⏳
Odanis BSK - "Glory" ⏳
Otis Kemp - "Fly Away" ⏳
Paul Zach - "Our Salvation is Bound Up Together" ⏳
RICHLIN - "Hidden"
Robson Nascimento - "Quando Eu Te Encontrei" ⏳
Savanofsky - "O my God" ⏳
Several Other Ghosts - "Are You Disappointed?" ⏳
Shiwan - "Watch It Fall" ⏳
Skye Peterson - "Suburbs"
Social Club Misfits - "Who That Is" feat. DJ Laz
SONS THE BAND & Tribl - "Only Ever Good" feat. Steve Davis & Jordan Colle ⏳
Swaizy & Battz - "PLAY IT SAFE"
Sydney Jones - "Back To Life (Empty Grave)" ⏳
Tasha Cobbs Leonard - "The Moment (Live)"
Tommy Iceland - "Outside Looking In" ⏳
Zahriya Zachary - "Simple Ways" feat. Bethany Wohrle ⏳
ZDIORX & 1K Pson - "HATE ME" ⏳
1K Phew & 1K Pson - "Church House Trap House"8/13BBSO Baia Mare - "Rădăcini" ⏳
Benja - "El centro eres tú" ⏳
Breska - "Metamorfosis" ⏳
Canon - "No Loss"8/14Caleb Gordon - "God Good"
Elias. - "Finish Line" ⏳
Nene Olajide - "Babana" ⏳
Tessah Dunn - "Stardust" ⏳8/15Fabien & ZAA_Music - "Walk In Love" ⏳
Valen Basbus - "Jesús no es una leyenda" ⏳8/16CMOI & Torino P - "No Rewind II" ⏳
nathan huang & Darla Baltazar - "GOOD TO ME"
Sandals Worship - "All I Want Is You" ⏳
Ventania, Pedro Valença & Manu - "Muda os Planos (Ao Vivo)" ⏳8/17Alex Eriomenco - "Тебя Узнавать" feat. Vita Eriomenco ⏳
BOUE - "Como Vos" ⏳
Daniel Mwanza - "Amour Infini" ⏳
Dylan Drye - "Light's Domain" feat. Neon Feather ⏳
Poor Bishop Hooper - "Psalm 138" ⏳
The Kid Phxntom - "WASABI" ⏳8/18Año Cero - "Fondo Del Mar" ⏳
Sajan Nauriyal - "Static"
Wesley Cruz - "Voltar ao Início" ⏳8/19A Mose & Dena Mwana - "Jireh" ⏳
Amy Grant - "Walk On Water"
Andres Volz - "Auf deine Weise" ⏳
Anthone Ray - "Mount Everest" ⏳
Aryn Michelle - "Every Closed Door" ⏳
Bethel Music - "I Still Believe" feat. Brian Johnson
Blanca & Ty Brasel - "Never Too Far"
Breanna Corjuc - "You Are Holy" ⏳
Clarensau - "When I Look Back" ⏳
Clarensau - "Eye to Eye" ⏳
Cody Carnes - "Good (Can't Be Anything Else) [Live]"
CRYS - "Doble Filo" ⏳
David & Nicole Binion - "I See Jesus" ⏳
Demon Hunter - "GODLESS" feat. Richie Faulkner
DJ LostNFound - "Back To The Wall" feat. BigBreeze, Truent & Weez the Satellite Kiid ⏳
Don Ready, Battz & Yung Kriss - "Heavenly Poetry 5" ⏳
Eddie Clark - "Turn Me Up" ⏳
Ervin Wilson - "The City Don't Care" feat. nobigdyl. ⏳
GRAHAM - "1 in 8 Billion"
Hannah Oliver - "Dear Jesus" ⏳
Harborside Music - "I'm Loved" ⏳
Hillside Recording & Diana Trout - "Wait on You" ⏳
House of Grace Worship - "You Came into this World" ⏳
Hulvey - "Have Me"
HYLEM - "ALMOST HOME" ⏳
Hyper Fenton & Moflo Music - "Swerving (Zoom Zoom Zoom)" ⏳
Isla Vista Worship - "sing praise"
Jay-Way - "Ice Cold"
Jeremiah Bligen - "Throne" feat. Dre Murray & L3XDIVINE
Jeremiah Coyne - "Revealed" ⏳
Jimmy Levy & Eugenics - "Safety" ⏳
Joe Gez - "Love You First" ⏳
John Michael Howell - "1,000 Lives"
John Tibbs - "Lay Your Head Down" ⏳
Jubril - "Save Me" ⏳
JXHN PVUL - "Emo" ⏳
Karmel - "Fogo" ⏳
Keyondra Lockett - "You Your Love" ⏳
knwbdy - "psa" feat. Spencer Boliou & wins ⏳
Laura Hackett Park - "Nothing Left to Prove"
Lazarus! - "GET BUSY" ⏳
LeAnn Rimes - "awakening"
Limoblaze & Emandiong - "Desire" ⏳
Lord Badu - "Angels" feat. Kinglsey Amiah ⏳
Manor Collective - "Forever" feat. Becca Folkes, Charlotte Kiwanuka & Junior Garr
Marvin Sapp - "Never Would Have Made It (Movie Soundtrack Single)" ⏳
Mike Teezy - "Back n Bold (Freestyle)"
N!x - "TNT" ⏳
Noah Brown - "SANCTIFY THE KID" ⏳
Olivia Grasso - "Lightning" ⏳
Paul Rarity - "Breathe" ⏳
Prodi Da Prodigal - "No Days Off" ⏳
Reblah & Shirlvin Desir - "Blessings from You" ⏳
Red Tips - "Big Move"
Rob Berg - "Long Time No See" ⏳
Rubinsky Rbk & MC Ari - "Corazón" ⏳
Seth Carpenter - "And Then" ⏳
Solarjet - "Lois Lane" ⏳
Soulsician - "I Wanna Wake Up" ⏳
Tbabz & S.O. - "So Special" feat. Ryan Hylton ⏳
Tenielle Neda - "Lifetime" feat. John Van Deusen ⏳
Thiago Grulha - "Um Passo de Cada Vez" ⏳
Todd McVicker - "Dynamite" ⏳
Tommy Royale - "G Como Becky" ⏳
Travis Ryan - "Praise God" ⏳
United Pursuit - "The Gate" feat. Brandon Hampton ⏳
Yelitza Cintron & Joe L Barnes - "King Of Glory" ⏳
Zach Williams - "Big Tent Revival"
Zambroa - L"Conquest (a romans 7:15 kind of thing)" ⏳8/21Caleb Gordon - "I Got Blessings"8/22Alex Jean - "Cant Stop Me" ⏳
Apollo LTD - "Run"8/23JusRzd & Weez the Satellite Kiid - "Mudd" ⏳8/24Young Oceans & Josh Garrels - "This Wild Earth (Subjects)" ⏳8/25S.O. - "ALREADY" ⏳8/26After Grace - "For My Good" feat. Joel Vaughn ⏳
aftrthght - "Simple" ⏳
Alvin Cedric - "Till My Heart Stops"
Anchor Hymns - "Altogether Good" feat. Paul Baloche & Lucy Grimble ⏳
Audacious Worship - "All In" ⏳
Beach Chapel - "You're Everywhere"
Ben Laine - "Come to The Table" ⏳
Brad & Rebekah - "Wellness" ⏳
C3 SYD - "Dancing Through The Fire" ⏳
CeCe Winans & Gabriela Rocha - "Believe For It" ⏳
Chase Wagner - "Only One" ⏳
Chris August - "Only You Can Do It"
Christ For The Nations Worship - "Kingdom" feat. Nicole Steffanoni ⏳
Colton Dixon - "Build a Boat (Acoustic)"
Common Hymnal - "Best I Can" feat. Seaux Chill, Andrew Blooms & Royce Lovett
Cooper Hill & Jachin McDonald - "Surf Bar" ⏳
DaShawn Shauntá - "Night Club" ⏳
Dillon Chase - "lo-feels" ⏳
Don Ryvcko - "I JUST WANNA BE WITH U" ⏳
Drakare - "Covered" ⏳
Evan Craft - "Fight On My Knees"
Greater Vision - "Older People" ⏳
Hannah Schaefer - "Upper Room" ⏳
Hillsong Worship - "Resurrender (Live At Team Night)" feat. Aodhan King
ISLY - "Nostalgia"
Isreal Perez - "GOTTA BE BLIND" feat. Coop ⏳
Jae Young - "Not Real" feat. Jon Keith
Jamie Grace - "Carry Me Through (Lo-fi)"
Jason Gray - "When I Say Yes"
Jekasole - "Can I" ⏳
John Jin Han - "Friend" ⏳
John Michael Howell - "Noah Guy"
Joshua Leventhal - "T H E G A L L O W S"
K-Anthony - "Nobody" ⏳
Kathy Troccoli - "Finally Free" ⏳
Lazarus! - "1st of the Month" ⏳
Manafest, OTTO BLUE & Liv Ash - "Born To Be a Legend"
Marv - "SO MUCH" ⏳
Melissa Bethea - "Awesome" ⏳
Mike Abdul - "Blessing Now" ⏳
Pauline Zoe Park - "Safe Place" ⏳
Phil Wickham - "Behold" feat. Anne Wilson
Philippa Hanna - "You're Still God (Live From The Old Chapel)"
Rachael Nemiroff - "S.O.S." ⏳
Red Tips - "On E"
Ri-An & Tommy Iceland - "I Surrender All (Allt till Jesus)" ⏳
Rita Springer & kalley - "Nothing To Buy"
Sarah Reeves - "Best Days"
Sean C. Johnson - "SIX THIRTY" ⏳
SEU Worship - "Pour It Out" feat. Dylan Dames
Shadowlands, Luke Laird & Sandra McCracken - "Hold Together" ⏳
SONS THE BAND & Tribl - "Cross and Empty Grave" feat. Steve Davis & Jordan Colle ⏳
Starringo - "No Awards"
Stephen Stanley - "Rest In The Father"
Steven Curtis Chapman - "I'm Alive"
Sundance Head - "Heaven Shines Down On You" ⏳
TEMITOPE - "PHARISEE IN ME" ⏳
The Listening Session - "Who Running Up" feat. Bill B., International Show & Weez the Satellite Kiid ⏳
Tim Godfrey - "God Turned It Around" feat. Nathaniel Bassey & Tim Bowman, Jr. ⏳
Vanessa Campagna - "Hold Me" ⏳
Vic Lucas - "Elevate" ⏳
We The Kingdom - "God Is On The Throne"
Wxlf & BigBreeze - "Please"
Zauntee - "Jesus Called My Name"8/27One Way - "Se Va a Mover" ⏳8/28Caleb Gordon - "Rocky Road"8/29ST-Saint - "Loving Life" ⏳8/30Alex Jean - "New Chapter" ⏳
O'Bed - "For Love Must Be Sincere" ⏳8/31Dirk - "Midnight" ⏳
Matthew Parker - "Boss Level" ⏳
Midian Nascimento, Coletivo Candiero & Filipe da Guia - "Preciso Gritar" feat. Calmará ⏳
Poor Bishop Hooper - "Psalm 140" ⏳Embed