New Music Friday 06/03/22 LyricsPost Malone - I Like You (A Happier Song) (with Doja Cat)
Polo G - Distraction
070 Shake - Medicine
Panic! At The Disco - Viva Las Vengeance
Maggie Rogers - Want Want
Bo Burnham - 1985
Post Malone - Wasting Angels (with The Kid LAROI)
Gucci Mane - Mrs. Davis
Remi Wolf - Cake
Yeah Yeah Yeahs - Spitting Off the Edge of the World
Phoenix - Alpha Zulu
Vory - Daylight ft. Ye
Jungle - GOOD TIMES
Clinton Kane - 14
Reneé Rapp - Tattoos
Why Don't We - How Do You Love Somebody
Post Malone - I Cannot Be (A Sadder Song) (with Gunna)
Yo Gotti - Big League (with Yo Gotti, Moneybagg Yo, CMG The Label feat. Mozzy & Lil Poppa)
Chris Young - If I Knеw What Was Good for Me
Lost Frequenciеs - Questions
aespa - Illusion
midwxst - sidelines
What So Not - Mr Regular (feat. Oliver Tree & Killer Mike)
AUDREY NUNA - sardines
Lakeyah - Mind Yo Business (Feat. Latto)
Cazzu - Nena Trampa
BAYLI - think of drugs
Vance Joy - Every Side Of You
Christina Aguilera - Suéltame
Swae Lee - Tupelo Shuffle (From The Original Motion Picture Soundtrack ELVIS)
Jax Jones - Lonely Heart
Amelia Moore - i feel everything
Deaton Chris Anthony - Good Buy My Old Life
EKKSTACY - I GAVE YOU EVERYTHING
DJ Snake - Disco Maghreb
Logic - Bleed It
B-Lovee - Demon (feat. Coi Leray)
San Holo - We Will Meet Again
Darkoo - There She Go (Jack Sparrow) [feat. Mayorkun]
Muse - Will Of The People
Eli Young Band - Tell Me It Is
Sada Baby - 2 Freaks (feat. Snoop Dogg)
RealestK - Don't Walk Away
Sub Urban - BANDIT
Maggie Lindemann - break me!
Goth Babe - Taking Over The Sun
Purity Ring - unlucky
Lous and The Yakuza - Monsters
NIKI - Before
Sophia Scott - Don't Tempt Me
Angel Olsen - Ghost On
Johnny Orlando - blur
Lonely God - Anotha 1
CORPSE - life waster
Eli Fross - Menace (feat. Fredo Bang)
Jean Deaux - Ease Up
Lava La Rue - Hi-Fidelity
Dagny - Brightsider
Emilia - intoxicao
Arin Ray - Bad Idea (feat. Blxst)
KayCyy - Hold you up (feat. Annahstasia & Steven Bamidele)
Tove Styrke - Free
Mt. Joy - Bathroom Light
Red Hot Chili Peppers - Nerve Flip
DE'WAYNE - GOOD MOOD (feat. grandson)
Brooke Eden - Left You For Me
Preslea Elliott - 6:33
Betty Who - Blow Out My Candle
New Rules - Love You Like That
NCT DREAM - Beatbox
Tiago PZK - Nos Comemos (feat. Ozuna)
TobyMac - The Goodness (feat. Blessing Offor)
Nia Sultana - Proven (with Rick Ross)
Strick - Nelly Furtado
India Shawn - EXCHANGE
Carol Ades - 26
salem ilese - Crypto ₿oy
Kid Bloom  - Cowboy
7evin7ins - Wake Up
Lil Loaded - Cell Tales
KB Mike - Need U (with Scorey)
Lil Tracy - Knight in Shining Armor
gigi - The Man
almost Monday - sun keeps on shining
VINCINT - Taste So Good (The Cann Song)
Nikki Lane - First High
Kassi Ashton - I Don't Go Back
Dalton Dover - Hear About a Girl
vivi rincon - if we lived on the moon
Grupo Firme - El Reemplazo
Lil Kee - What You Sayin
S.G. Goodman - If You Were Someone I Loved
Andrew Bird - Eight
Horsegirl - Option 8
KenTheMan - No Panties
Fastmoney Ant - War Cries
Jules Paymer - I Would Probably Hate You
Arlie - break the curseEmbed