New Music Friday 09/02/16 LyricsSongs with a ✅ contain verified annotations and/or lyrics!

Zara Larsson - Ain't My Fault
Kent Jones - Alright
Cash Cash & Digital Farm Animals - Millionaire feat. Nelly (Alan Walker Remix)
FRENSHIP - 1000 Nights
Sylvan Esso - Radio
Sting - I Can't Stop Thinking About You
FRND - Friend
Bon Iver - 33 "GOD"
Usher - Rivals feat. Future
Ellie Goulding - Still Falling for You (Jonas Blue Remix) ✅
VHS Collection - Waiting on the Summer
Mokita & Cade - Monopoly
James Vincent McMorrow - Evil
Les Gordon - Paradise feat. ADI
Dagny - Ultraviolet
Weezer - I Love the USA
Win and Woo - Recognize feat. Ashe
Ty Dolla $ign - 3 Wayz feat. Travis Scott
Erick Morillo & Eddie Thoenick - Lost in You feat. Angel Taylor
Sankehips - Cruel feat. ZAYN (Jay Pryor Remix)
Youngr - Out of My System
A Day to Remember - We Got This
Jimmy Eat World - Sure and Certain
Bastille - Send Them Off!
Blink-182 - Bored to Death (Steve Aoki Remix)
French Montana - 2 Times
Anderson .Paak - Am I Wrong (Live from Spotify House SXSW '16)
Fitz and The Tantrums - HandClap (Feenixpawl Remix)
The Radio Dept. - Swedish Guns
Dominique - Love You Better
PARTYBABY - California
Tokyo Police Club - My House
Skylar Grey - Come Up for Air
Nightly - XO
All Time Low - Take Cover
SAFIA - My Love is Gone
Gemini - The Turnaround
Shakey Graves - Tomorrow
Angel Olsen - Never be Mine
AlunaGeorge - Mediator
Sno - Sunrise
Declan McKenna - Isombard
Action Bronson - Descendants of the Stars (Traveling the Stars Theme)
Yo Gotti - Wait for It feat. Blac Youngsta
The Courteeners - No One Will Ever Replace Us
Grouplove - Enlighten Me
R.LUM.R - Frustrated (Russ Macklin Remix)
Zedd & Grey - Adrenaline
Sondar - Ready
SOHN - Signal
Codeko - Walking with Lions feat. Raphaella (Official Electric Zoo Anthem)
MOD SUN - Gucci Nail
Gucci Mane - Last Time feat. Travis Scott
WSTRN - A-List
The Raconteurs - Carolina Drama (Acoustic Mix)
Alex Aiono - One Dance/Hasta El Amanecer (Mashup)
Tory Lanez - Ride (Ginuwine Cover) [Live from Spotify House SXSW '16]
Ryan Follese - Put a Label On It
Seth Ennis - Woke Up in Nashville
Michael Bublé - I Believe in You
Gavin Degraw - Kite Like Girl
Ben Hobbs - Animals
Sweekuh - How We Do feat. Cosmos & Creature
James Blake - Timeless feat. Vince Staples
Tkay Maidza - Carry On feat. Killer Mike
M.I.A. - Freedun feat. ZAYNEmbed