New Music Friday 11/30/18 LyricsMeek Mill - Going Bad (feat. Drake)
6ix9ine - KIKA (feat. Tory Lanez)
benny blanco - Better To Lie (with Jesse & Swae Lee)
The 1975 - I Always Wanna Die (Sometimes)
Chance the Rapper - My Own Thing
Grimes - We Appreciate Power
Los Unidades - E-Lo (feat. Jozzy)
6ix9ine - TIC TOC (feat. Lil Baby)
Meek Mill - On Me (feat. Cardi B)
Clean Bandit - Mama (feat. Ellie Goulding)
Mac Miller - Dunno - Recorded at Spotify Studios NYC
Gesaffelstein - Reset
Kodak Black - Calling My Spirit
Dounia - If U Wanna
Shallou - count on
Alice Merton - Funny Business
Alessia Cara - Out Of Love
ZAYN - Rainberry
Travis Scott - SICKO MODE - Skrillex Remix
The 1975 - Be My Mistake
Gryffin - Bye Bye
Sasha Sloan - Again
Call Me Karizma - Serotonin
Nina Nesbitt - Colder
Lila Drew - november
Henry Jamison - Ether Garden
Famous Dex - Catch A Body
Cheat Codes - Feeling of Falling
Phoebe Bridgers - Christmas Song
Jay Rock - Shit Real (feat. Tee Grizzley)
KEY - Love On Ice (feat. 6LACK)
Sharon Van Etten - Jupiter 4
Ski Mask The Slump God - LA LA
ROLE MODEL - six speed
Earl Sweatshirt - December 24
Jax Jones - Play
Halsey - Without Me - ILLENIUM Remix
Gabrielle Aplin - My Mistake
Calum Scott - Need To Know
Saweetie - Pissed
Leland - Middle Of A Heartbreak
Kelly Rowland - Kelly
AFI - Trash Bat
RY X - YaYaYa
R3HAB - Fuego
graves - I'm Fine
Circa Waves - Movies
Ex:Re - Romance - Edit
The Strumbellas - Salvation
A.CHAL - DÉJALO
Kwame - CLOUDS.
Nicky Romero - My Way (ft. Alice Berg)
Tory Lanez - TAlk tO Me (with Rich The Kid feat. Lil Wayne) - Remix
Kat Saul - Nick Miller
DROELOE - Through The Storm
Tessa Violet - Bad Ideas
FKJ - Is Magic Gone
Kirsten Arian - Velvet Dresses
JID - Westbrook (with A$AP Ferg)
Alejandro Sanz - No Tengo Nada
Cash Cash - Call You (feat. Nasri of MAGIC!)
Emily Burns - Damn Good Liar
Dominique - Payup
Cayucas - Winter of '98
Sophia Scott - She Ain't Me
Axwell - Nobody Else
Nacho - Déjalo
Ex:Re - Romance
Arctic Monkeys - Anyways
INNA - Iguana
ricky retro - 1977
Cageless Birds - Ain't No Grave
Elderbrook - Old Friend
Golden Vessel - MOONSTONE
Aitana - Vas A Quedarte
YNW Melly - Mischief On My Mind
Lucy Grimble - Keeper
Fever High - Avec You
Jesse & Joy - Te Esperé
Men I Trust - Say, Can You Hear
Audien - Rollercoaster
Skizzy Mars - Like Me More
The Code - Moments
KB - Die Rich
DaniLeigh - Can't Relate (feat. YBN Nahmir, YG)
Lake Street Dive - Young Boy
Jeff Tweedy - I Know What It's Like
Elvis Crespo - Ella Me BesóEmbed