New Music Friday 03/22/19 LyricsTame Impala - Patience
Dean Lewis - Stay Awake
Why Don't We - I Don't Belong In This Club
Logic - Confessions of a Dangerous Mind
Alan Walker - On My Way
Rich The Kid - Fall Threw (feat. Young Thug & Gunna)
NAV - Price On My Head (feat. The Weeknd)
Lizzo - Tempo (feat. Missy Elliott)
Jonas Blue - What I Like About You (feat. Theresa Rex)
Becky G - Green Light Go
Nicky Jam - Te Robaré
Pia Mia - Bitter Love
Pink Sweat$ - Coke & Henny Pt. 1
Ryan Trey - Nowhere To Run
PnB Rock - I Like Girls (feat. Lil Skies)
Destiny Rogers - North$ide
Steve Aoki - Play It Cool
Danny Ocean - Veneno
Ra Ra Riot - Bad To Worse
Rayana Jay - Hangover (feat. G-Eazy & Beni Moun)
Flume - High Beams
Maggie Lindemann - Friends Go
Jacquees - Your Peace (feat. Lil Baby)
Foster The People - Style
Loote - 85%
Mike Perry - Closer
Megan Thee Stallion - Sex Talk
MARINA - Orange Trees
Paloma Mami - Fingías
Black Caviar - El Camino
DJ Snake - SouthSide
ILLENIUM - Pray (feat. Kameron Alexander)
Catfish and the Bottlemen - 2all
Ruth B. - Don't Disappoint Me
Two Door Cinema Club - Talk - Single Edit
Calexico - Father Mountain
Sofi Tukker - Fantasy
Jasmine Thompson - more
Fitz and The Tantrums - 123456
flora cash - I Wasted You
Hearts & Colors - Lion
Mötley Crüe - Ride With The Devil
LANCO - Rival
Wallows - Remember When
Kailee Morgue - Headcase
Tierra Whack - Unemployed
DDG - Hold Up (feat. Queen Naija)
I Prevail - Paranoid
DJ Luke Nasty - Bread
Naughty Boy - Undo (with Calum Scott & Shenseea)
Lostboycrow - Violet Sky
Cody Lovaas - Talk Slow
Ej Jackson - Back Around
Dan Talevski - If I Ain't Got You
The Maine - Broken Parts
Andrew Bird - Olympians
Jenny Lewis - Rabbit Hole
Sara Bareilles - Saint Honesty
BJ The Chicago Kid - Close
Burna Boy - 34
Melii - Fresh Air
Baka Not Nice - My Town (feat. Giggs)
Aaron Carpenter - Attitude
Mosa Wild - Night
Inhaler - It Won't Always Be Like This
Glowie - Cruel
Boosie Badazz - Bonnie and Clyde
Nilüfer Yanya - Baby Blu
MorMor - Outside
Dounia - LOWKEY GRL (feat. Moroccan Doll)
Wrabel - i want you
Jamila Woods - EARTHA
Little Jesus - Fuera de Lugar
Shlohmo - The Best of Me
Mat Zo - Tracing Steps
Surfaces - Palm Trees
JAMESDAVIS - Dodger Black
Jessy Wilson - Clap Your Hands
Easy Life - Sunday
cleopatrick - sanjake
Zero - W W Y D F
Sublime With Rome - Blackout
Peggy Gou - Starry Night - Edit
Grimes - Pretty Dark - Demo
Posa - Trap Love
WurlD - Drown
Amaal - Coming & Going
Poundside Pop - 2500
MOSES - I Think You Worry Too Much
DENM - Life's Too Short
YOTA : Youth of the Apocalypse - Fire in My Mind
Dirty Honey - When I'm Gone
Plague Vendor - New Comedown
Arlo Parks - Romantic Garbage
Bruce Hornsby - Cast Off
Raffaella - NASA's Fake
Caveboy - LandslideEmbed