New Music Friday 09/08/17 LyricsHailee Steinfeld & Alesso - Let Me Go feat. Watt & Florida Georgia Line
ZAYN - Dusk Till Dawn feat. Sia
​iLoveMakonnen - Love feat. Rae Sremmurd
Kelly Clarkson -Love So Soft
Thomas Rhett- Leave Right Now
G-Eazy - No Limit feat. Cardi B & A$AP Rocky
Sam Smith- Too Good At Goodbyes
ODESZA - Falls feat. Sasha Sloan
Tove Lo - Disco Tits
Beck - Up All Night
U2 - You’re The Best Thing About Me
Nothing But Thieves - Particles
The National - Dark Side of the Gym
Arty - Supposed To Be
R3HAB & Quentino - I Just Can't
SZA - Quicksand
Lao Ra - Me Gusta feat. Afro B
Kevin Gates - Had To
Miguel - Shockandawe
Foo Fighters - The Line
Grey & Skott - Crime
Nina Nesbitt - The Best You Had
The Americanos - Everyday feat. DRAM & Kyle
Lil Durk - Goofy feat. Future & Jeezy
Young Thug & Carnage - Homie feat. Meek Mill
Above & Beyond - My Own Hymn feat. Zoë Johnston
Demi Lovato - You Don't Do It For Me Anymore
Maty Noyes - Say It To My Face
St. Vincent - Los Ageless
JOHN.k - OT
Blake Shelton - I'll Name the Dogs
Kane Brown - Found You
Aquilo - I Could Fight On A Wall
Miriam Bryant - Rocket feat. NEIKED
Loote - Out Of My Head
Anna Of The North - Always
Dvsn - Mood
Starrah & Diplo - Swerve
DJ Kay Slay - Jealousy feat. Busta Rhymes, Tech N9ne, The Game & Meet Sims
Yandel - Sólo Mía feat. Maluma
Robin Schulz & HUGEL - I Believe I'm Fine
3LAU - Star Crossed
Bryce Vine - Drew Barrymore
Poo Bear - Will I See You feat. Anitta
A Boogie Wit da Hoodie - Beast Mode feat. PnB Rock & YoungBoy Never Broke Again
MUTEMATH - Break The Fever
Alvvays - Lollipop (Ode To Jim)
Sleeping With Sirens - Trouble
Filous - For Love feat. klei
Shallou - Begin (Recorded at Spotify Studios NYC)
Belle Mt - Hollow
OBB - Mona Lisa
The Belonging Co - Peace Be Still feat. Lauren Daigle
Linkin Park & Steve Aoki - Darker Than The Light That Never Bleeds (Chester Forever Steve Aoki Remix)Embed