New Music Friday 03/25/22 LyricsJ Balvin - Sigue
A$AP Rocky - Lost and Found Freestyle 2019 (with Tyler, The Creator & Nigo)
Machine Gun Kelly - make up sex (feat. blackbear)
Tate McRae - chaotic
Maren Morris - Humble Quest
Chance the Rapper - Child of God
Latto - Sunshine (feat. Lil Wayne & Childish Gambino)
Zach Bryan - Highway Boys
Daddy Yankee - X ÃšLTIMA VEZ
Nicki Minaj - We Go Up (feat. Fivio Foreign)
Summer Walker - No Love (with SZA & Cardi B) - Extended Version
Charli XCX - Selfish Girl
Martin Garrix - Follow
Fireboy DML - Playboy
Omar Apollo - Tamagotchi
Beabadoobee - Talk
FINNEAS - Naked
24kGoldn - In My Head (feat. Travis Barker)
Rema - Time N Affection
Disclosure - WatÐµrfall
Lykke Li - NO HOTEL
Tai Verdes - 3 outfits
JamÐµs Bay - Give Me The Reason
ROLE MODEL - neverletyougo
Paulo Londra - Plan A
Keshi - ANGOSTURA
Key Glock - I Be
Kid Cudi - Stars In The Sky - From Sonic The Hedgehog 2
Michael BublÃ© - Bring It On Home to Me
Sabrina Claudio - Better Version
Lous and The Yakuza - KisÃ©
Denzel Curry - Troubles (feat. T-Pain)
42 Dugg - Free The Shiners
Yung Lean - Trip
Maluma - Mojando Asientos (feat. Feid)
ODESZA - Love Letter (feat. The Knocks)
Red Velvet - Feel My Rhythm
JESSIA - Next Time
Anson Seabra - Unloving You
Nicky Youre - Never Go Wrong
Sarcastic Sounds - Disappointment (feat. Rxseboy)
Wallows - Marvelous
COIN - Killing Me
Weezer - The Garden of Eden
Sheff G - Break From It
Koffee - Shine
Celeste - To Love A Man
Mxmtoon - sad disco
Surf Mesa - Marching Band ðŸ•’
Sofia Carson - It's Only Love, Nobody Dies
Red Hot Chili Peppers - Not the One
Cannons - Tunnel of You
Barrie - Jersey
Del Water Gap - Complicated - Spotify Singles
Jensen McRae - Take It Easy
Kilo Kish - DEATH FANTASY
Channel Tres - Acid in My Blood
Buddy - Hoochie Mama
Fredo Bang - No Love (feat. Sleepy Hallow)
Mike. - up again
Jamie Miller - Last Call
Christina Perri - evergone
The Head And The Heart - Tiebreaker
Brantley Gilbert - RolexÂ® On A Redneck
Jake Owen - Up There Down Here
Louis The Child - Cry (with Aluna)
Girlpool - Nothing Gives Me Pleasure
Soccer Mommy - Shotgun
Fana Hues - BAD bad
Leith Ross - We'll Never Have Sex
Catie Turner - Nothing
ASTN - You're Almost There
TELYKast - Loveless (with Teddy Swims)
Alesso - Only You
Crawlers - I Can't Drive
Blessing - character
Baird - Backboard
Sally Sossa - Toot It Up (with Flo Milli)
Coco Jones - Caliber
Matisyahu - Mama Please Don't Worry
Rose Betts - Hate Me
NERIAH - AT LEAST I'M GOOD AT IT
Eli Derby - Go Home
KA$HDAMI - posed2be
Stunna 4 Vegas - Pay Me To Speak
Danny orange - say it twice
Wilfred - 23
Kev Kelly - Royal Blue
Bree Runway - Somebody Like You
Ogi - Envy
David Unlayao - If We Ever Break Up
Ian Noe - Tom Barrett
Holden Miller - Far Side of the World
Daisy Grenade - Baby Blackout
Mnnyyz - For The Low
Unfoonk - DEA
Coast Contra - 505
Pino - don't call meYou might also likeEmbed