New Music Friday 3/26/21 LyricsJustin Bieber - Lifetime
Lil Nas X - MONTERO (Call Me By Your Name)
Taylor Swift - You All Over Me (feat. Maren Morris) (Taylorâ€™s Version) (From The Vault)
Rod Wave - Richer (feat. Polo G)
KAROL G - EL MAKINON
Internet Money - JETSKI (feat. Lil Mosey & Lil Tecca)
Coi Leray - BIG PURR (Prrdd) (feat. Pooh Shiesty)
BROCKHAMPTON - BUZZCUT (feat. Danny Brown)
The Kid LAROI - Shot For Me - Spotify Singles
Ali Gatie - Do You Believe
24kGoldn - Love Or Lust
Moneybagg Yo - Hard For The Next (with Future)
Tate McRae - bad ones
benny blanco - Unlearn (with GraciÐµ Abrams)
Jungle - Keep Moving
serpentwithfeet - HÐµart Storm (with NAO)
Demi Lovato - Dancing With The Devil
Julia Michaels - All Your Exes
NF - JUST LIKE YOU
AJR - 3 O'Clock Things
beabadoobee - Last Day On Earth
Sub Urban - PATCHWERK (with Two Feet)
Slush Puppy - Juliette
Wolf - Hydra
Major Lazer - Titans (feat. Sia & Labrinth)
YBN Nahmir - WooWAM
Calboy - Miseducation (feat. Lil Wayne)
Princess Nokia - It's Not My Fault
Alaina Castillo - indica
Rag'n'Bone Man - Fall in Love Again
All Time Low - Once In A Lifetime
Young Dolph - Penguins
YNW Melly - Na Na Na Boo Boo
Nicki Nicole - No Toque Mi Naik
Mimi Webb - Good Without
Cian Ducrot - Crocodiles
Gallant - Dynamite.
Bren Joy - Insecure (feat. Pink Sweat$)
Kenny Mason - Play Ball
Peach Tree Rascals - Change My Mind
Georgia Webster - Push & Pull
Maddie & Tae - Woman You Got
Reiley - Let It Ring
Russ - BANKRUPT
Sleepy Hallow - 2 Sauce
Pipe Bueno - Tequila
IU - LILAC
ZHU - Sky Is Crying
The Knocks - R U HIGH (feat. Mallrat)
mehro - not alone
Savannah Sgro - Until We Drink
Noga Erez - Fire Kites
Patrick Droney - State of the Heart
Fiji Blue - Wait!
Audrey Mika - Chivalry
Sofia Carson - Fool's Gold
JVKE - Home
JUMEX - EX BEST FRIEND
BlueBucksClan - Lil League (feat. Quavo & Hit-Boy)
Big Scarr - SoIcyBoyz 3 (feat. Gucci Mane, Pooh Shiesty, Foogiano & Tay Keith)
Pacman da Gunman - Zero Tolerance
Lonely God - Built For This
Goth Babe - Laurelhurst ðŸ•’
Evann McIntosh - JENN!FER AN!STON
Jax - 90s Kids ðŸ•’
Jackson Wang - LMLY
Chiiild - Sleepwalking
Shelley FKA DRAM - Cooking With Grease
VIC MENSA - FR33DOM (ft. Zacari)
Quando Rondo - Angel Wings
BigKayBeezy - Heartless
Juhn - Indecente
Becky Hill - Last Time
Ross Copperman - Electricity
Chloe Angelides - Friends Who Failed At Love
underscores - Spoiled little brat
Sam Ryder - Tiny Riot
Johnny Orlando - I Donâ€™t (with DVBBS)
FITZ - Spaceman
Royal Blood - Limbo
Evanescence - Broken Pieces Shine
Olive Amun - Blues
Delacey - Boy With The Blues
Arden Jones - roll the dice
Prettyboyworldwyde - Lullabies
Thomas Headon - Bored
Ben Howard - Metaphysical Cantations
Elevation Worship - Jireh (feat. Chandler Moore & Naomi Raine)
Andrew Jannakos - Wine Country
Teddy Swims - Til I Change Your Mind ðŸ•’
Grace Weber - Thru The Fire (feat. Chance the Rapper)
Enchanting - Want Sum
Big Jade - No Hook ðŸ•’
Trapboy Freddy - Oakcliff (feat. Yella Beezy, Young Nino, Smurf Franklin & Hotboy Star) ðŸ•’
Badda TD - Glitch (feat. Rowdy Rebel)
midwxst - Smile
Anthony Ramos - Say Less
Anna of the North - Here's To Another
Justin Quiles - Como Si Nah (feat. KEVVO)
Bobby Sessions - Cog In The MachineEmbed