New Music Friday 01/18/19 LyricsDean Lewis - 7 Minutes
James Blake - Mile High
Ariana Grande - 7 rings
Future - First Off (feat. Travis Scott)
Logic - Keanu Reeves
Maren Morris - GIRL
Maggie Rogers - Burning
Toro y Moi - Monte Carlo
Future - Faceshot
Isabella LoveStory - Humo
Mike Posner - Noah's Ark
FRENSHIP - Wanted A Name
James Blake - Power On
R3HAB - BAD!
Alice Merton - Learn to Live
Anuel Aa - Secreto
Sia - Genius (with Lil Wayne, Sia, Diplo & Labrinth - Lil Wayne Remix)
Emotional Oranges - Hold You Back
Sharon Van Etten - You Shadow
Rynx - Hold On
Why Don't We - BIG PLANS
Hikaru Utada - Face My Fears - English Version
Tyga - Floss In The Bank
YoungBoy Never Broke Again - Kick Yo Door
Cub Sport - Video
PUP - Kids
Weyes Blood - Andromeda
Sammie - Times 10 (feat. Lil Baby)
Terror Jr - Pretty
Jack & Jack - Barcelona
Old Dominion - One Man Band
Jade Bird - I Get No Joy
Mansionair - Shadows
Saint Agnes - Welcome to Silvertown
Becky G - LBD
Backstreet Boys - Breathe
James Morrison - My Love Goes On (feat. Joss Stone)
Casanova - 2AM (feat. Tory Lanez & Davido)
SWMRS - Trashbag Baby
Mustard - Pure Water (with Migos)
Yung Pinch - Nightmares (feat. Lil Skies)
Papa Roach - Come Around
Sigrid - Don’t Feel Like Crying
dodie - Monster
John The Blind - Two Months
Matisse & Sadko - Don’t Tell Me
UPSAHL - Drugs
G Herbo - Up It
Hozier - Almost (Sweet Music)
The Japanese House - Maybe You're the Reason
YUNGBLUD - Loner
Deerhunter - Futurism
MOD SUN - Tell Me All Your Secrets
Alec Bailey - Grip
Witt Lowry - HURT
LOVA - My Name Isn’t
half•alive - arrow
Lil Skies - Real Ties
Sky - Bajo Cero
Call Me Loop - Silly Boy
Tobe Nwigwe - SHINE (feat. Madeline Edwards)
Lost Kings - FU4E
Slushii - Never Let You Go (feat. Sofia Reyes)
j ember - Wishing For Rain
The Killers - Land Of The Free
HARDY - I'LL QUIT LOVIN' YOU
FEVER 333 - ONE OF US
Sofi Tukker - Mi Rumba
Lily & Madeleine - Can't Help the Way I Feel
James TW - You & Me
Lauren Aquilina - If Looks Could Kill
Methyl Ethel - Trip The Mains
Ella Vos - Temporary
Dreezy - RIP Aretha
Mabel - Don't Call Me Up
YNW Melly - Mixed Personalities (feat. Kanye West)
Dan Caplen - Love Me the Same
Delaney Jane - Throwback
Sean Paul - Shot & Wine
Quinn Lewis - Hanging On
Bones Owens - Bout Time
Daisy the Great - Dips
Cass McCombs - The Great Pixley Train Robbery
Frank Carter & The Rattlesnakes - Crowbar
G Flip - Drink Too Much
The Moth & The Flame - Only Just Begun
K CAMP - Switch
Sebastian Yatra - Un Año
INNA - Sin Ti
Jukebox The Ghost - The Other Side
Griffin Stoller - Liars
Violet Skies - Is She Gonna Be There?
Peking Duk - Sugar
John Paul White - The Long Way Home
Branan Murphy - Coming Home
Des Rocs - Outta My MindEmbed