New Music Friday 11/17/17 LyricsLuis Fonsi & Demi Lovato - Échame La Culpa
Diplo - Get It Right feat. MØ
G-Eazy - The Beautiful & Damned feat. Zoe Nash
Lil Uzi Vert - 20 Min
Miguel - Pineapple Skies
Steve Aoki & Lauren Jauregui - All Night
Fall Out Boy - HOLD ME TIGHT OR DON’T
Machine Gun Kelly, X Ambassadors & Bebe Rexha - Home
Blackbear - gucci linen feat. 2 Chainz
Tory Lanez - I Sip
Dashboard Confessional - We Fight
Maggie Lindemann - Obsessed
PnB Rock - Lovin' feat. A Boogie Wit da Hoodie
T-Pain - 2 Fine feat. Ty Dolla $ign
Lauv - Paris in the Rain
Massari - Number One feat. Tory Lanez
Tame Impala - List Of People (To Try And Forget About)
BLAISE - Dua
Calum Scott - You Are The Reason
Tove Lo - shedontknowbutsheknows
DRAM - Crumbs feat. Playboi Carti
Kap G - Marvelous Day feat. Lil Uzi Vert & Gunna
Andy Grammer - Freeze
Olivia O'Brien - Tequilawine
6LACK - Glock Six
Poo Bear & Juanes - All We Can Do
Ivy Adara - Famous
Ella Vos - Suddenly
Camila Cabello & Daddy Yankee - Havana (Remix)
Matoma - Slow feat. Noah Cyrus
Tritonal - Call Me
Cappa - Waste My Time
Hunter Hayes - More
San Holo - One Thing
Roy Woods - Say Less
Maxo Kream - Bussdown
Jaden Smith - Breakfast feat. A$AP Rocky
Chris Stapleton - Tryin' To Untangle My Mind
Björk - Blissing Me
Airplane Man - New Supplier
Wild Child - Expectations
Teenage Wrist - Swallow
Green Day - Back in the USA
The National - Carin At the Liquor Store (Recorded at Spotify Studios NYC)
Brandi Carlile - The Joke
FRANKIE - Coping
Jessie J - Queen
Russell Dickerson - Yours (intl mix)
Nick Lachey - Someone to Dance With
Flo Rida - Hola feat. Maluma
Dropout & Wendy Sarmiento - No Scrubs
Parson James - Only You
Tim McGraw & Faith Hill - Devil Callin' Me Back
Sia - Candy Cane Lane
CyHi The Prynce - No Dope On Sundays feat. Pusha T
Mr Eazi - Pour Me Water
Louis Futon - Restless Sea feat. Opia
Wolf Alice - Don't Delete The Kisses (Recorded at Spotify Studios London)
Hatchie - Sure
VHS Collection - Sign
Charlotte Day Wilson - Doubt
Arlo - Safe
Moon Taxi - Let The Record Play
The Neverly Boys - Burn, Hollywood, Burn
Higher Brothers - Flo Rida feat. Ski Mask The Slump God
Lil Peep - Save That ShitEmbed