New Music Friday 08/25/17 LyricsTaylor Swift - Look What You Made Me Do
Lil Uzi Vert - The Way Life Goes
Thirty Seconds To Mars - Walk On Water
Demi Lovato - Tell Me You Love Me
Fifth Harmony - He Like That
JP Cooper - Wait
Astrid S - Think Before I Talk
Miguel - Sky Walker feat. Travis Scott
Jorja Smith & Preditah - On My Mind
London On Da Track - No Flag feat. Nicki Minaj, 21 Savage & Offset
XXXTENTACION - Fuck Love feat. Trippie Redd
Wu-Tang Clan - People Say feat. Redman
Beck - Dear Life
Foo Fighters - The Sky Is A Neighborhood
Queens of the Stone Age - Domesticated Animals
Ayokay - Too Young feat. Baker Grace
Colouring - If I Ever Lose Your Love
Quinn XCII - Always Been You
Luke Bryan - Light It Up
Wingtip - Cross Your Mind feat. morgxn
R3HAB & Khrebto - You Could Be
Old Dominion - So You Go
Iron & Wine - Bitter Truth
The War On Drugs - Nothing To Find
Quicksand - Illuminant
The Killers - Wonderful Wonderful
Lana Del Rey & BloodPop® - Lust For Life (BloodPop® Remix) feat. The Weeknd
Ofenbach & Nick Waterhouse - Katchi
BROCKHAMPTON - SWEET
Busta Rhymes - Girlfriend feat. Vybz Kartel & Tory Lanez
Buddy - Last Time feat. Kent Jamz
MadeinTYO - Too Quick
Action Bronson - 9-24-7000 feat. Rick Ross
Daniel Caesar - Hold Me Down
Cash Cash - All My Love feat. Conor Maynard (Sagan Remix)
Bridgit Mendler & RKCB - Diving
Jacob Sartorius - Skateboard
Noah Cyrus - Almost Famous
Charlie Puth - Attention (Recorded at Spotify Studios NYC)
Timeflies - One Hit Wonder
The Script - Written in the Scars
Mags Duval - Don't Ask Me
Rod Stewart - Da Ya Think I'm Sexy? feat. DNCE
PVRIS - Anyone Else
Bhad Bhabie - These Heaux
A$AP Mob - Please Shut Up feat. A$AP Rocky, KEY & Gucci Mane
Elliot Root - 10,000
Hannah Ellis - Temporary Feeling
Jeffrey East - Still Crazy
Blanca - Real Love1Embed