New Music Friday 09/11/20 LyricsMy Window (feat. Lil Wayne) - YoungBoy Never Broke Again
OK Not To Be OK - Marshmello
Don Don - Daddy Yankee
I Got You (ft. Busta Rhymes) - Trippie Redd
Godspeed - James Blake
Oh My Gawd (feat. Nicki Minaj & K4MO) - Mr Eazi
Let's Love - David Guetta
Bad Habits - Usher
Love Looks Better - Alicia Keys
Blue Sky - Serena Isioma
Worth It - beabadoobee
Shh...Don't Say It - FLETCHER
Our Time - Lil Tecca
HELL BENT (with The Kid LAROI) - TOKYO’S REVENGE
ok on your own (feat. Carly Rae Jepsen) - mxmtoon
Long Live - Florida Georgia Line
Don't Start Now - Ingrid Andress
Turntables (from the Amazon Original Movie "All In: The Fight for Democracy") - Janelle Monáe
Letter To You - Bruce Springsteen
as long as you care - Ruel
That Girl - Khamari
BS - Still Woozy
Loose (feat. KSI) - S1mba
Found You - Ludacris
Lose Somebody - Jack Gilinsky
Nobody Gets Me (Like You) - Wallows
Pop Like This (feat. Yo Gotti) - YBN Nahmir
Ring (feat. Young Thug) - T.I.
Plot Twist - NIKI
Kamikaze - Omar Apollo
hole in the bottle - ballerini album version - Kelsea Ballerini
Happiness - John K
Drivin Thru the Night - Petit Biscuit
Teen Scene feat. Buddy - Maeta
TALK ABOUT IT - Keedron Bryant
I Love Me Too - KIRBY
Bridges - Mickey Guyton
Be a Rebel - Edit - New Order
Visitor - Of Monsters and Men
Elephant In The Room (feat. gnash) - Dempsey Hope
Know You - Dreamer Boy
Want You - Luh Kel
Move - Stefflon Don
Baptize (with JID & EARTHGANG) - Spillage Village
Killshot - Sad Night Dynamite
Beyond the Pine - Tash Sultana
Someone Else’s Dream - Absofacto
Everybody Wants You - Johnny Orlando
Undercover - Gabrielle Current
nostalgic (luvsick) - renforshort
Feeling Myself - Adam Turley
Sometimes - badmonsham
Right Now - Toosii
Streets Ain't Safe (feat. Blxst) - Mozzy
FEM - DaVido
Helpless - Rhye
Loud - Delilah Montagu
GO FAST BABY - Raissa
Numb (feat. DeathbyRomy & PVRIS) - Kiiara
Mala Vida - Nicki Nicole
DIRT - B.o.B
Effortless - Ant Saunders
Better In College (feat. Ashe) - Robert DeLong
The Curse (feat. Mac Demarco) - Yellow Days
Keep Your Head Up - Djo
DON'T CHASE THE DEAD - Marilyn Manson
Air Max - Comethazine
Kobe (feat. Snoop Dogg & Derrick Milano) - Dame D.O.L.L.A
Distance - María Isabel
Roster - Bailey Bryan
wild - Carly Rose
BEDROOM - Tyzo Bloom
Bloom - Gabriel Garzón-Montano
Drinking Wine - Oscar Lang
Jesus (feat. Kacy Hill) - Jimi Somewhere
Company - Leyla Blue
Dear Scarlett - Cameron Dallas
Forever Tre-7 (feat. No Savage) - Shy Glizzy
Seen Everything But Jesus (feat. Freddie Gibbs) - Conway the Machine
Golden Eye - Action Bronson
18 - Turbo
Get Over You - Joel Blackmon
Vampire - Noah Cunane
Graduation - Ebenezer
damn Right - AUDREY NUNA
Live A Little - Chaz Cardigan
Let Down - Michigander
Chemicals - The Vamps
A Million - Mannywellz
Connected (feat. 42 Dugg) - LPB Poody
Over Yonder (feat. Matt Stell) - Lathan Warlick
Boys From The Puget Sound - Ayron Jones
Say It First - Jutes
Can You Feel The Sun - MISSIO
Being You - Beulahbelle
City Girl - Ari PenSmith
No Security (feat. Kevin Gates) - Fredo Bang
Grimey (feat. Sleep Walkin SLT) - Jaah SLT
Made It (Can't Stay) - Eli SostreEmbed