New Music Friday 4/17/20 LyricsPlayboi Carti - @ MEH
DaBaby - ROCKSTAR (feat. Roddy Ricch)
Sam Smith - I‚Äôm Ready (with‚ÄÖDemi‚ÄÖLovato)
Joji - Gimme‚ÄÖLove
Jeremy Zucker - somebody loves you
21‚ÄÖSavage - Secret (feat. Summer Walker)
Powfu - im used to‚Åüit
Rina‚ÅüSawayama‚Åü- Bad Friend
Kid‚ÅüCudi - Leader‚ÅüOf The Delinquents
Diplo - Do Si Do (with Blanco Brown)
Bazzi - I Got You
Florence + The Machine - Light Of Love
Kygo - Freedom
French Montana - That's A Fact
Lil Tecca - Out Of Love (feat. Internet Money)
dvsn - 'Flawless' Do It Well Pt. 3 (feat. Summer Walker)
Fiona Apple - Shameika
Brittany Howard - You and Your Folks, Me and My Folks - Recorded at East West Studios
Still Woozy - Window
Tate McRae - you broke me first
Y2K - Go Dumb (feat. blackbear, The Kid LAROI and Bankrol Hayden)
iann dior - Sick and Tired
girl in red - midnight love
Anson Seabra - Emerald Eyes
John Legend - Bigger Love
Kelly Clarkson - I Dare You
Dua Saleh - umbrellar
[Kenny Mason - PTSD] üêö
Kehlani - Everybody Business
The Kid LAROI - Fade Away
Jamie xx - Idontknow
Ela Minus - they told us it was hard, but they were wrong. - Edit
Ti√´sto - Nothing Really Matters
Rvssian - No Me Ame
Kelly Rowland - COFFEE
Chloe x Halle - Catch Up (feat. Swae Lee & Mike WiLL Made-It)
La Roux - Automatic Driver - Tyler, The Creator Remix
Max Leone - The Beach
Jason Mraz - Look For The Good - Single Version
Jack Gilinsky - My Love
Christian French - i think too much
Lady Antebellum - Champagne Night - From Songland
Brett Eldredge - Gabrielle
Oh Wonder - Keep On Dancing
Noah Cunane - Miami
bbno$ - what would baby do
Westside Gunn - French Toast
Buddy - Bad Boys
Fredo Bang - Get Even
Dillon Francis - Touch
The Streets - Call My Phone Thinking I'm Doing Nothing Better
Amber Mark - Waiting - Demo
Tiana Major9 - Think About You - Notion Mix
The-Dream - Wee Hours
Pitbull - I Believe That We Will Win (World Anthem)
Becky G - They Ain't Ready
Cheap Cuts - Check Your Phone (Feat. Pete Wentz of Fall Out Boy)
Sueco the Child - Juice
Deante' Hitchcock - I Got Money Now (feat. JID)
[YFN Lucci - Designer Junkie]üêö
Camilo - El Mismo Aire
Lost Frequencies - Love To Go
Lauren Jauregui - 50ft.
Blu DeTiger - Figure It Out
Lime Cordiale - On Our Own
Hayley Williams - Why We Ever
Brad Paisley - No I in Beer
Morgan Wallen - More Than My Hometown
Lola Young - None For You
[Lido Pimienta - Resisto Y Ya]()üêö
Kaash Paige - Frank Ocean
Tech N9ne - Dr. Sebagh
Jackboy - Like a Million
Lil Keed - No Dealings
Blueface - Tour
Jonah Mutono - The Low
Gerry Cinnamon - Head in the Clouds
A Day To Remember - Mindreader
The Used - Cathedral Bell
Car Seat Headrest - Hollywood
Nate Traveller - Airport
Rence - Tears In December
Zhavia Ward - Waiting
Duke Dumont - Nightcrawler
Justin Jesso - If you're meant to come back
≈Åaszewo - Sad Bitch
Kelsy Karter - Devil On My Shoulder
RIMON - Out Of My Way
Paige - Yellow
EOB - Banksters
Ruston Kelly - Brave
Jameson Rodgers - Cold Beer Calling My Name
Angels & Airwaves - All That's Left Is Love
Lil Loaded - Wit The Business
Lil Benny - Company
Elah Hale - My House
[Naeem - Simulation (feat. Swamp Dogg, Justin Vernon)]()Embed