New Music Friday 11/04/22 LyricsDrake - Pussy & Millions (feat. Travis Scott)
Selena Gomez - My Mind & Me
Joji - Die For You
Tiësto – 10:35
P!nk - Never Gonna Not Dance Again
Drake - Major Distribution
A Boogie Wit da Hoodie - Ballin
BROCKHAMPTON - Big Pussy
hemlocke springs - girlfriend
Phoenix - After Midnight
Gryffin - Lose Your Love (with Matt Maeson)
Jessie Murph - If I Died Last Night
Russell Dickerson - Sorry
Sleepy Hallow - Marie
Drake - Privileged Rappers
Masego - Say You Want Me
Q - Today
Jason Derulo - Never Let You Go
Avril Lavigne - I'm a Mess (with YUNGBLUD)
FLETCHER - Suckerpunch
Dean Lewis - All For You
Saint Harison - why didn't you call???
SG Lеwis - Lifetime
Tobe Nwigwе - They Want It, But No
NLE Choppa - Ice Spice
ThxSoMch - SPIT IN MY FACE!
Cavetown - heart attack
Stephen Sanchez - Missing You (with Ashe)
Olivia O'Brien - Never Be The One
DJ Snake - Nightbird
Gorillaz - Baby Queen
Mora - DOMINGO DE BOTE
Elmiene - Why (Spare Me Tears)
Luke Bryan - Prayin' In A Deer Stand
Teddy Swims - The Plan☑️
First Aid Kit - Palomino
MorMor - Here It Goes Again
Quevedo - Punto G
David Guetta - You Can't Change Me (feat. Raye)
Nelly - Birthday Girl (feat. Chris Lane) 🐚
Madeline Edwards - Mama, Dolly, Jesus
Anson Seabra - Hard To Be Human
quinnie - itch
Arden Jones - not afraid at all
Zai1k - Drive Me Crazy
Scribz Riley - Satisfied
Lecrae - Still In America
Sam Fischer - Carry It Well
Two Friends - Graduated (feat. Bryce Vine)
John Summit - Show Me (feat. Hannah Boleyn)
Goth Babe - I'm in Luv 🐚
Payday - Boyfriend
Suki Waterhouse - Neon Signs
SEB - loving u is harder
The Lone Bellow - Wherever Your Heart Is
Mickey Guyton - I Still Pray
Sigrid - Everybody Says They’re Fine
J. Maya - Machine Learning
Samia - Mad At Me
Dylan Sinclair - Never
Paulo Londra - A Veces (feat. Feid)
Regard - No Love For You🐚
Austin George - Off Season
Mills - Hands On Me🐚
Lauren Weintraub - Over Her Over Here
Tyla - To Last
KUČKA - Not There
Coco & Clair Clair - Be With U (feat. DETO BLACK)
Niko Rubio - Olvidar De Ti
Abby Cates - Lawrence
The Rare Occasions - Start This Over
nothing,nowhere. - CYAN1DE (feat. Pete Wentz)
Pivot Gang - 911☑️
Lil Poppa - WIN 4 LOSIN (with Rylo Rodriguez)
Blessd - Que Duro
Yves Tumor - God Is a Circle
Connie Constance - Kamikaze 🐚
Coco Jones - Crazy For Me
Will Troy - Mercy 🐚
Aly & AJ - With Love From
Johnny Orlando - if he wanted to he would
Ayron Jones - Otherside
Magnolia Park - Radio Reject
SpotemGottem - Block Got Hot 🐚
Chris Jedi - DURO
SIPHO. - ARMS (Edit) 🐚
Dominic Sen - Love To Be (feat. sadie 🐚)
Okay Kaya - Jazzercise
Kenyon Dixon - Friend Zone 🐚
Ye Ali - Safe 🐚
ghost orchard - cursive 🐚
Rayland Baxter - My Argentina 🐚
Noel Gallagher's High Flying Birds - Pretty Boy
Anna of the North - Living Life Right
Zach Hood - i ain't rich, girl
Wilfred - blue jean overalls
PEGGY - LOVE
Crawlers - Too Soon
Piwa - Feel Free 🐚
Peter Collins - You Got This 🐚Embed