New Music Friday 10/11/19 LyricsHarry Styles - Lights Up
Camila Cabello - Easy
YUNGBLUD - original me (feat. dan reynolds of imagine dragons)
French Montana - Twisted (feat. Logic & A$AP Rocky)
88rising - Walking (feat. Swae Lee & Major Lazer)
A R I Z O N A - Problems
Pusha T - Puppets (Succession Remix)
Roddy Ricch - Big Stepper
Kash Doll - How It’s Done (with Kim Petras, ALMA, Stefflon Don) - From "Charlie's Angels (Original Motion Picture Soundtrack)"
City Girls - JT First Day Out
Caribou - Home
R3HAB - Exhale
YK Osiris - Fake No Mo
Internet Money - Somebody
Sam Hunt - Kinfolks
BENEE - Find an Island
Alexander 23 - See You Later
Mike Posner - Fun Up Here (feat. Logic)
Wale - Routine (feat. Rick Ross & Meek Mill)
BabyJake - 239
Chloe Lilac - Special
Lost Kings - LA & The Parties
MEDUZA - Lose Control
Moneybagg Yo - All Dat (with Megan Thee Stallion)
Lil Tjay - One Take
Terrell Hines - Get Up
Jack Larsen - Vanity
James Arthur - You (feat. Travis Barker)
Green Day - Fire, Ready, Aim
Luke Combs - What You See Is What You Get
Blanco Brown - Funky Tonk
The Black Eyed Peas - RITMO (Bad Boys For Life)
Mau y Ricky - BOTA FUEGO
YoungBoy Never Broke Again - Make No Sense
Gucci Mane - Tootsies (feat. Lil Baby)
Hayley Kiyoko - Demons
Bishop Briggs - JEKYLL & HIDE
Cigarettes After Sex - Falling In Love
Destiny Rogers - Lo Lo (feat. P-Lo & Guapdad 4000)
Blueface - Close Up (feat. Jeremih)
FKA twigs - home with you
MorMor - Won't Let You
Tiana Major9 - Collide - From "Queen & Slim: The Soundtrack"
Shordie Shordie - Both Sides (feat. Shoreline Mafia)
Rubi Rose - Hit Yo Dance
SebastiAn - Sober
Syn Cole - Cool With That
Plested - The Least That I Could Do
Winona Oak - Let Me Know
Baby Ariel - wildside
Waterparks - Easy To Hate
The Neighbourhood - Yellow Box
Big Thief - Two Hands
Nilüfer Yanya - H34T RISES
Gerry Cinnamon - Sun Queen
Miranda Lambert - Tequila Does
Lady Antebellum - Boots
Ella Henderson - Young
JoJo - Joanna
Rich Music LTD - Uniforme
Casanova - So Drippy (feat. Gunna & Young Thug)
Grip - No Info
Baka Not Nice - UP
Michael Kiwanuka - Hero
Afro B - Condo
Harry Hudson - Mean To Love
Two Feet - You?
jame - Freefall
ROLE MODEL - hello!
khai dreams - Sandals
EDEN - untitled
Moby Rich - Loser
Drama Relax - Lonely
Kid Ink - Bats Fly (feat. Rory Fresco)
Fantasia - Bad Girl
TINI - Oye
Starley - Lovers + Strangers
Yellow Claw - Amsterdamned
Deborah's Child - Dear God
Yoshi Flower - Addicted
Next Town Down - Wonderin'
Yelawolf - Opie Taylor
John The Blind - Bottle of Pills
MisterWives - the end
James Blunt - I Told You
Bailey Bryan - Where We Started
LANCO - What I See
CNCO - Pegao
UMI - Love Affair
Lukas James - Young
Hovvdy - Mr. Lee
Simple Creatures - One Little Lie
Caro - just one night
Berhana - I Been
Father - ICEMAN
Aaron May - Talk My ShytEmbed