New Music Friday 12/14/18 LyricsNicki Minaj and Anuel AA - Familia (feat. Bantu)
Ariana Grande - Imagine
ZAYN - There You Are
Kodak Black - Moshpit (feat. Juice WRLD)
Bad Bunny - Solo de Mi
The Chainsmokers - Hope (feat. Winona Oak)
Gryffin - You Remind Me (feat. Stanaj)
A Boogie Wit Da Hoodie - Startender (feat. Offset and Tyga)
Matt Maeson - The Mask
Miley Cyrus and Mark Ronson - Happy Xmas (War is Over) (feat. Sean Ono Lennon)
Smokepurpp - Sauce Like This
SAINt JHN - White Parents Are Gonna Hate This
gnash - t-shirt
Judah & the Lion - Quarter-Life Crisis
Maggie Rogers - Tim McGraw - Recorded at Spotify Studios NYC
Tiny Tiny - The Flood
Your Smith and Japanese Wallpaper - Bad Habit (Japanese Wallpaper Remix)
nothing,nowhere. - Ornament
Carlie Hanson - Numb
Juan Magán and Deorro - Muñequita Linda
Higher Brothers - 16 Hours
Kid Ink - YUSO (feat. Lil Wayne and Saweetie)
Quinn XCII - Tough (feat. Noah Kahan)
Alan Walker and Sorana - Lost Control
MJ Cole and Freya Ridings - Waking Up
Mokita - London
Allie X - Last Xmas
Matt Berninger and Stephan Altman - All I Want
ILIRA - GET OFF MY D!CK
LightSkinKeisha - I'm Gucci
Yung Gravy - Alley Oop (feat. Lil Baby)
Zhavia Ward - 100 Ways
Conditions - Give It All
Ayoho - The End - Early Edition
Mitchell Tenpenny - Goner
Avril Lavigne - Tell Me It's Over
Airways - Blue Gasoline
Bianca Rhoden - Out of Words
Vic Mensa - In Some Trouble (feat. Ty Dolla $ign)
Aaron Taos - Loneliness
Robin Thicke - Testify
Devin Dawson - Placebo - Songs in the key of F - Live
Dreezy - Chanel Slides (feat. Kash Doll)
AJ Mitchell - No Plans (feat. Marteen)
Grace Weber - Joy To The World
Filmore - Heart's Having A Heart Time
Elton John and Khalid - Young Dumb & Broke - Recorded At The Colosseum, Caesar's Palace, Las Vegas
Set It Off - For You Forever
Night Flight and Gerald Gerald - Song To Fall Asleep
Switchfoot - ALL I NEED
Randy Houser - New Buzz
The Native Sibling - You Would
Delaney Jane - Psycho
Okey Dokey - One by One
Pitbull and Rhea - Ocean to Ocean
The Lumineers - Pretty Paper
Tamzene - Last Song
Cass McCombs - Estrella
YFN Lucci - Double Up (feat. Rich The Kid)
Rival Sons - Feral Roots
I Am Karate - Work It Out
We Three - Lifeline
Papa Roach - Elevate
In Flames - (This Is Our) House
The Band CAMINO - Less Than I Do
slenderbodies - king
Martin Garrix and Julian Jordan - Glitch
LEISURE - Falling
Tall Heights - House on Fire
YGTUT - Get It
DaBoyDame, Yo Gotti and G-Eazy - Dreams (feat. Dej Loaf)
PRETTYMUCH - Jello
Rico Nasty - Guap (LaLaLa)
Joseph - Sister Winter1Embed