New Music Friday 08/10/18 LyricsLSD - Thunderclouds (feat. Sia, Diplo, & Labrinth)
Quavo - W O R K I N M E
Nina Nesbitt - Loyal to Me
Broods - Peach
J. Cole - Album of the Year - Freestyle
Chantel Jeffries - Better
Louis the Child - Dear Sense (feat. MAX)
Why Don't We - 8 Letters
Maluma - Mala Mía
Nicki Minaj - Barbie Dreams
Elle King - Shame
Twenty One Pilots - Levitate
Kane Brown - Weekend
Jai Wolf - Lost (feat. Chelsea Jade)
Trippie Redd - Taking A Walk
Stefflon Don - Pretty Girl
Loren Gray - My Story
DREAMERS - All Washed Out
Jason Mraz - Let's See What The Night Can Do
Lauren Daigle - Still Rolling Stones
Foxing - Slapstick
Quavo - B U B B L E G U M
RÜFÜS DU SOL - Underwater
R.LUM.R - Right Here
Danny Ocean - Epa Wei
Ciara - Freak Me (feat. Tekno)
gnash - dear insecurity (feat. Ben Abraham)
Gucci Mane - Kept Back (feat. Lil Pump)
Troye Sivan - Animal
Abby Anderson - Dance Away My Broken Heart
Don Q. - Yeah Yeah (feat. 50 Cent, A Boogie Wit Da Hoodie, & Murda Beatz)
girl in red - 4am
The O'My's & Saba - Pubbles
Sports - Cadillac
Skepta, Suspect, & Shailan - Stay with It
Method Man - Grand Prix
Tom Morello - Rabbit's Revenge (feat. Bassnectar)
Gallant - In the Room: Doesn't Matter (feat. A$AP Ferg & VanJess)
Elley Duhé - FEVER
Wafia - I'm Good
Trevor Myall - Pyro Heart
Dermot Kennedy - Heartless - Recorded at RAK Studios, London
Mitski - Two Slow Dancers
Captain Cuts, Zookëper, & Georgia Ku - Do You Think About Me
Cuban Doll & YBN Nahmir - Big Chop
Skye & Chris Brown - Fairytale
Folly Rae - The One
Wild Nothing - Shallow Water
Red Velvet - Bad Boy (English Version)
You Me At Six - I O U
SYML - Where's My Love - Sam Feldt Club Mix
Be The Bear - I Don't Want To
Cassadee Pope - One More Red Light
Chromeo x THEY. - Must've Been (feat. DRAM)
Avonlea - Cars and Boys
India Lake - Girl in New York City
Jake Owen - Down To The Honkytonk
Jessie Reyez- Sola
Elderbrook - Capricorn
No Jumper - Rivals (feat. KILLY & Smooky MarGielaa)
Fetty Luciano & Bobby Shmurda - On The Wall
Walker McGuire - I'm on It
Moses Sumney - Call-to-Arms
Salt Cathedral - Rudeboy
Big Red Machine - Deep Green
DILLY DALLY - Sober Motel
Lykke Li - U Got It Bad - Recorded at Spotify Studios Stockholm
DROELOE & Nevve - Weird Machine
Yoshi Flower - Brown Paper Bag
The Struts - Primadonna Like Me
CMC$, Grx, & Icona Pop - X's
Reese LAFLARE - Nosebleeds (feat. Young Thug)
Half the Animal - Magic
Aphex Twin - T69 collapse
Marissa Nadler - Blue Vapor
Dan Parsons - Dream on Lover
Toto - Hash Pipe
Passenger - To Be Free
Thutmose & NoMBe - Run Wild
Phora - Come Thru
Old Dominion - Bad At Love - Recorded at Sound Stages Studios Nashville
SHAED & snny - You Got Me Like
Wet - 11 Hours (Branchez Remix)
Amos Lee - Dying White Light
Daniella Mason - Human
Young Nudy - Zone 6
Phony Ppl - Before You Get a Boyfriend.
Bethel Music & Josh Baldwin - Stand In Your Love (Radio Version)
Switchfoot - You Found Me (Unbroken: Path To Redemption)
Casting Crowns - Only Jesus
Maty Noyes - New Friends
Jordan Smith - End In Love
Medasin - Work For You (feat. Kaz Moon)
TheGifted & Sam Fischer - Restless
Adam Friedman - Bloom
Ro James - Excuse Me
Nef The Pharoah - What We Have (feat. DeJ Loaf)
St. Paul & The Broken Bones - GotItBad
Cher - Gimme! Gimme! Gimme! (A Man After Midnight)
Dave Grohl - Play1Embed