New Music Friday 07/21/17 LyricsPRETTYMUCH - Would You Mind
X Ambassadors - Ahead Of Myself
Louis Tomlinson - Back to You feat. Bebe Rexha & Digital Farm Animals
A-Trak - Believe feat. Quavo & Lil Yachty
Foster The People - I Love My Friends
Don Diablo - Momentum
NAV & Metro Boomin - Minute feat. Playboi Carti & Offset
Ghosted - Get Some feat. Kamille
Sage The Gemini - Grip feat. Kent Jones
Steve Aoki - If I Told You That I Love You feat. Wale
Leland - Mattress
Lana Del Rey - Beautiful People Beautiful Problems feat. Stevie Nicks
Nothing But Thieves - Sorry
Kevin Gates - No Love
Romeo Santos - Un Vuelo A La feat. Jessie Reyez
Lauv - Don't Matter (Recorded at Spotify Studios NYC)
Amin√© - Wedding Crashers feat. Offset
Meek Mill - We Ball feat. Young Thug
Smallpools - Passenger Side
Old Dominion - Shoe Shopping
KREAM - Drowning feat. Clara Mae
Dan Croll - Tokyo
Declan McKenna - Listen to Your Friends
Roy Woods - What Are You On?
Tyler, The Creator - I Ain't Got Time!
Justine Skye - Back for More feat. Jeremih
A$AP Twelvyy - Diamonds feat. A$AP Rocky
Jillian Jacqueline - God Bless This Mess
The War On Drugs - Strangest Thing
Bruno Major - Cold Blood
Emily Warren - Something to Hold on To
Lophiile, Moss Kena & Nick Grant - Newno
Damian Marley - R.O.A.R
Chase Atlantic - Keep It Up
Skott - Mermaid
Sultan + Shepard - Almost Home feat. Nadia Ali & IRO
NVDES - Do You Think About Me
Kelsey Bulkin - Andromeda
Kid Froopy - Drive Slow
Linzi Jai - Morose
Poppy - Interweb
Nine Inch Nails - This Isn't the Place
Grizzly Bear - Neighbors
Morgan Evans - Kiss Somebody
Billie Eilish - idontwannabeyouanymore
PANDA$ - PARI$ feat. Jutes
Kristian Galva - Wrong 4 This
Noah Kahan - Fine
Bel Heir - Sunny Days
Cornelius - In A Dream
Linkin Park - FaintEmbed