New Music Friday 03/04/22 LyricsCamila Cabello - Bam Bam (feat. Ed Sheeran)
DaBaby - Turbo
Dominic Fike - Elliot's Song - From "Euphoria" An HBO Original Series
Machine Gun Kelly - ay! (feat. Lil Wayne)
Omah Lay - Attention
Diplo - Let You Go
Wet Leg - Angelica
King Von - Straight To It (feat. Fivio Foreign)
Charli XCX - Baby
Khalid - Last Call
Kane Brown - Leave You Alone
A Boogie Wit da Hoodie - Hit Different (feat. B-Lovee)
Blxst - Sometimes
Stromae - Fils de joie
Labrinth - I'm Tired - From "Euphoria" An HBO Original Series
HAIM - Lost Track
Sueco - Drunk Dial
David Kushner - Mr. Forgettable
5 Seconds of Summer - COMPLETE MESS
Pusha T - Hear Me Clearly (with Nigo)
ODESZA - B–µtter Now (feat. MARO)
BENEE - Nev–µr Ending
Dora Jar - It's Random
Cochise - DO IT AGAIN
David Guetta - Trampoline (feat. Missy Elliott, BIA and Doechii)
MICHELLE - POSE
Ashe - Another Man's Jeans
Joey Bada$$ - Head High
Morray - Still Here (feat. Cordae)
Shenseea - Deserve It
Nil√ºfer Yanya - the dealer
Chelsea Cutler - What Everybody Wants
Danielle Bradbery - Look At The Mess I'm In
Prince Royce - Te Espero
Dave - Starlight
Tinashe - HMU for a Good Time
Tom The Mail Man - Over
Keshi - GET IT
Ali Gatie - Crying in the Rain
Red Hot Chili Peppers - Poster Child
Bob Moses - Hanging On
Yung Bae - L.O.V.E. (feat. EARTHGANG, Jon Batiste & Sherwyn)
Tee Grizzley - Beat The Streets
Krewella - Drive Away
Robyn - Buffalo Stance
Luna Li - What You're Thinking
Sad Night Dynamite - Black & White
Powfu - sleeping on the floor
Wallows - At the End of the Day
Cecilia Gault - Kira Kira
Baby Tate - Sl*t Him Out Again (feat. Kali)
J.I the Prince of N.Y - I Ain't Gon Lie
Hotboii - Lately
Jack White - Hi-De-Ho
Adriel Favela - Contigo No Fue
Blake Rose - Confidence
ROSIE - Next Life
Matt Hansen - better off without me
Mitchell Tenpenny - Horseshoes and Hand Grenades
Cole Swindell - Down To The Bar (feat. HARDY)
Cheat Codes - Payback (feat. Icona Pop)
Sofi Tukker - Forgive Me
DUCKWRTH - Power Power (feat. Shaun Ross)
G-Eazy, Kossisko & Swae Lee - Find That Girl
Popcaan - Skeleton Cartier
The FaNaTiX - Vroom - from GRAN TURISMO 7
Band of Horses - Warning Signs
Sir Chloe - Mercy
BETWEEN FRIENDS - more
Amelia Moore - moves
Leah Kate - Dear Denny
Emmit Fenn - Freak (with Vandelux)
Kojey Radical - Talkin (feat. Kelis & Tiana Major9)
Yungeen Ace - Life of Sin
Bktherula - Coupe
Caspr - Hate Me (feat. Travis Barker)
Kid Sistr - Palpitations
CLAY - WTSGD (with Alessia Cara)
KAINA - Golden Mirror
Lou Roy - Down Since '07
Re6ce - collision course
Hunxho - Made Me (feat. NoCap) üïí
Lancey Foux - Cooler Than Me
Cruel Santino - HEATING ROCKS
Tiana Major9 - Try Peace...
Goyo - Otra Noche
Renao - Struck Gold
Peach Pit - Give Up Baby Go
Alana Springsteen - Me Myself and Why
The Dip - Sleep On It
Alice Merton - Same Team
Bartees Strange - Heavy Heart - Edit
BlueBucksClan - See The Difference üïí
LORA - bittersweet
KAWALA - Marathon
Fanclubwallet - Gr8 Timing!
Alok - Meu Amor
Marc Anthony - Nada de Nada
Ceramic Animal - I Love A Stranger
BabyTron - Crocs & Wock' üêöYou might also likeEmbed