New Music Friday 07/10/20 LyricsJuice WRLD - Wishing Well
Summer Walker & PARTYNEXTDOOR - My Affection
Kane Brown - Be Like That (feat. Swae Lee & Khalid)
James Blake - Are You Even Real?
Anitta - Tócame (feat. Arcangel & De La Ghetto)
Avenue Beat - F2020
blackbear - queen of broken hearts
Kid Cudi - The Adventures Of Moon Man & Slim Shady (feat. Eminem)
Katy Perry - Smile
J.I the Prince of N.Y & Myke Towers - Spanglish
Juice WRLD & Marshmello - Come & Go
H.E.R. - Do To Me
Dominic Fike - Politics & Violence
Bazzi - I Don't Think I'm Okay
Tory Lanez - Staccato
contradash - white lie
100 gecs - hand crushed by a mallet (Remix) (feat. Fall Out Boy, Craig Owens & Nicole Dollanganger)
Zara Larsson - Love Me Land
KAROL G - Ay, DiOs Mío
StaySolidRocky & Lil Uzi Vert - Party Girl (Remix)
YG - Swag
Russ - Give Up
Evann McIntosh - WIYULD
Aminé - Compensating (feat. Young Thug)
DJDS - Simple Things (feat. Tory Lanez & Rema)
Rich Brian - Love In My Pocket
Future Islands - For Sure
James Bay - Chew On My Heart
Quinn XCII - Am I High Rn (feat. blackbear)
Emilee - Hide
Tainy & J Balvin - Agua
KAYTRANADA - Look Easy (feat. Lucky Daye)
Flo Milli - Weak
Baby Rose - Marmot
Jimmie Allen & Nelly - Good Times Roll
Meghan Trainor - Make You Dance
RAYE - Natalie Don't
Alok, Martin Jensen & Jason Derulo - Don't Cry For Me
Snoh Aalegra - DYING 4 YOUR LOVE
G-Eazy - Sun Bleached & Dried
MASN - Hate Me!
Kid Bloom - Sledgehammer
beaux - Look How We Started
Christian French - make or break up
Becky G - My Man
(G)I-DLE - i'M THE TREND
Ashnikko - Daisy
Flipp Dinero - Rich Today
Lil Gotit - What It Was (feat. Future)
Ryan Trey - Rollin
Terrace Martin, Robert Glasper & 9th Wonder - Sleepless Nights (feat. Kamasi Washington & Phoelix)
CHAII - Lightswitch
Sevana - If You Only Knew
Easy Life - Pop Tarts
Gabrielle Current - Sun Will Find You
Cavetown - Smoke Signals (feat. Tessa Violet)
X Lovers - Fuck What People Say
Patrick Droney - Passerby
Brett Eldredge - Magnolia
My Morning Jacket - Feel You
Margo Price - Hey Child
The Avett Brothers - Victory
Ann Marie & G Herbo - Stress Relief
Blueface & Coyote - Yea Yea
Desiigner - Hate Me Now (FREESTYLE)
Tiwa Savage - Dangerous Love
Sinead Harnett - Stickin' (feat. Masego & VanJess)
Deacon - Long Run (feat. Nina Nesbitt)
ELIO - u and me, but mostly me
Spencer Barnett - eta
Rhys Lewis - Some Days
Rascal Flatts & Rachel Wammack - Quick, Fast, In A Hurry
Tim McGraw - Here On Earth
Barns Courtney - Hard To Be Alone
Nightly - not like you
Sally Sossa - Who You Are
Quin Nfn - Detroit Flow
valentina cy - Bad
Donna Missal - Slow Motion
Gerard Way - Here Comes The End (feat. Judith Hill)
Black Thought - Thought Vs Everybody
Boldy James & The Alchemist - Pots and Pans (feat. The Cool Kids & Shorty K)
MadeinTYO - Square Bitch (feat. A$AP Ferg)
DreamDoll & Fivio Foreign - Ah Ah Ah
Jacob Collier - He Won't Hold You (feat. Rapsody)
Fiji Blue - I Should've Told You
Stephen Sanchez - Lady by the Sea
Junior Mesa - Losing My Grip
Lakeview - She Drove Me To The Bar
Picture This - Unconditional
Bon Jovi - American Reckoning
Sufjan Stevens - My Rajineesh
Jacob Latimore, Trevor Jackson & Rotimi - Real Love, Pt. 2
MK xyz - Pass It (feat. G-Eazy)
Duke Deuce - Kirk Franklin (feat. Mulatto)
Lute - Life
GOLDN - 143
Abir - Inferno
12AM - come over
Jackboy - In My CityEmbed