New Music Friday 1/01/21 LyricsAnyone - Justin Bieber
2021 - Lauv
You Need Me - Black Coffee
Love Is Back - Celeste
Better Than Feeling Lonely - Olivia O'Brien
Real Groove - Studio 2054 Remix - Kylie Minogue
No Son Of Mine - Foo Fighters
Keep My Name Outta Your Mouth - The Black Keys
how 2 find hope - redveil
i don't want another sorry - Dax
Ailleurs - Aya Nakamura
When The Lights Go Out - Gabrielle Aplin
Fillin' My Cup (feat. Little Big Town) - Hailey Whitters
The Sun Is In Your Eyes - Voice Memo - Jacob Collier
weekends - Hojean
D–µsahogo - KEVVO
FEEL ALRIGHT - Tiffany Day
NxBody - TheHxliday
Pandemia - Original - Ir Sais
Radioactive Rain - Smith & Th–µll
Sober - Bailey Bryan
unimpressed - Magsy
To Be Loved By You - Parker McCollum
Better Life - Joshua Radin
New Year Song - Andrew McMahon in the Wilderness
on the road (feat. Chas M) - guardin
lunch finisher - blackwinterwells
NO ONES THERE - Yung Pinch
Adrenaline - You Me At Six
Muffin - KIITA
Bucket List - Mitchell Tenpenny
All God's Children - Tauren Wells
Words - Barry Gibb
Wonderful Way - Hannah Grace
You Stay by the Sea - Axel Fl√≥vent
Emotion feat. Wild Nothing - Molly Burch
Consistent - Jacquie
GO BESTIE! - Shotgun Willy
fruit2 / fleas - 93FEETOFSMOKE
Just for Kids - Ben Kweller üêö
I Don't Mind - Christian Lopez
TRUE - SYML
Heaven - JUNG
Afterparty - Abigail Barlow
goblin - Kiko
Nothing Like Me (feat. Conway The Machine & Dios Moreno) - Uncle Murda üêö
Untitled 2 - dylAn
Impressed - Sleepa
Still Luv - Kennedy Rd.
Good Die Young - Marlhy
ALLTHETIME - POLICE CAR COLLECTIVE
Amanda Shires - That's All
Box - DYLN
Feel the Love - Da√∞i Freyr
Another Year - Lilianna Wilde
Love For Real - svrite
Elvis '77 - The Dirty Nil
You Are Not Alone - Krezip
Jumprope - NERIAH
semiautomatical - R‚±ØHM ‚öâEmbed