New Music Friday 07/19/19 LyricsBeyoncé - MOOD 4 EVA
Sam Smith - How Do You Sleep?
Quality Control - Baby
Alec Benjamin - Jesus In LA
Bazzi - I.F.L.Y.
Tones and I - Never Seen the Rain
Beyoncé - BROWN SKIN GIRL
XXXTENTACION - Royalty (feat. Ky-Mani Marley, Stefflon Don & Vybz Kartel)
Surfaces - Take Some Time
Charli XCX - Gone
mxmtoon - seasonal depression
Charlotte Lawrence - Why Do You Love Me
Tory Lanez - Forever
Rich Brian - Kids
Anuel AA - China
Tierra Whack - MY POWER
Willow - PrettyGirlz
King Princess - Prophet
Sabrina Carpenter - I Can't Stop Me
Billy Ray Cyrus - Chevys and Fords
Lil Pump - Pose To Do (feat. French Montana and Quavo)
Lil Tecca - Bossanova
Red Hearse - Half Love
Freya Ridings - Unconditional
MAX - Acid Dreams
Aaron Smith - Unspoken
Ross Golan - Stay Positive
Miranda Lambert - It All Comes Out in the Wash
The Lumineers - It Wasn't Easy To Be Happy For You
Brittany Howard - Stay High
IDER - Saddest Generation
Nas - Vernon Family
Phora - The Dream
iann dior - what is real
Shawn Mendes - If I Can't Have You - Gryffin Remix
Dounia - SAW IT FIRST
Chase B - MAYDAY
Lil Durk - Bougie (feat. Meek Mill)
Maxo Kream - The Relays (feat. Travis Scott)
YBN Nahmir - Fuck It Up (feat. City Girls & Tyga)
kenzie - HOT
Leslie Grace - Sola
The All-American Rejects - Send Her To Heaven
Sum 41 - The New Sensation
Hey Violet - Queen Of The Night
Hayley Kiyoko - I Wish
Sasha Sloan - at least i look cool
Four Tet - Dreamer
Kierra Luv - Ride My Wave
(Sandy) Alex G - Hope
Adam Melchor - Joyride
The Highwomen - Redesigning Women
Tori Kelly - Language
Leon Bridges - That Was Yesterday
Bishop Briggs - Champion
Whitney - Valleys (My Love)
half•alive - Pure Gold
Cosmo's Midnight - Have It All (feat. Age.Sex.Location)
Nicole Bus - Mr. Big Shot
Aaron Carpenter - Chase
A$AP Ferg - Wam (feat. MadeinTYO)
YoungBoy Never Broke Again - 4 Sons of a King
Martin Garrix - These Are The Times (feat. JRM)
Jonas Blue - I Wanna Dance
Skrillex - Fuji Opener
93PUNX - 3 Years Sober
Wilco - Love Is Everywhere (Beware)
Electric Guest - Dollar
Anthony Ramos - Dear Diary
Sinead Harnett - Pulling Away (feat. Gallant)
Smith & Thell - Hotel Walls
Boombox Cartel - Drip
Yella Beezy - Tattoo (feat. Too $hort)
Mak Sauce - Do It (feat. DaBaby)
Iggy Azalea - Fuck It Up (feat. Kash Doll)
Baby Keem - ORANGE SODA
Cassie - Speaking Of
daydream Masi - Hot Mess
Generationals - Xeno Bobby
girl in red - i'll die anyway.
Ryland James - In My Head
Noah Gundersen - Lover
116 - California Dreamin
Comethazine - Stand
Rahn Harper - Insecure
Zac Greer - Glitter
The Goo Goo Dolls - Money, Fame & Fortune
Quinn Lewis - Hurt Me Now
Jacob Collier - Feel (feat. Lianne La Havas)
Justine Skye - MAYBE
PRETTYMUCH - Lying (feat. Lil Tjay)
Conro - Thrill of It
Knife Party - No Saint
keshi - skeletons
slenderbodies - away from you
Phebe Starr - Bad News
BUNT. - Cuba (Tiene Sabor) [feat. Omara Portuondo]
Sleeping With Sirens - Break Me Down
Elijah Woods x Jamie Fine - TasteEmbed