New Music Friday 09/18/15 LyricsDemi Lovato - Confident
Ellie Goulding - On My Mind
Big Grams - Lights On
Moguai - Hold On feat. Cheat Codes
R. City - Make Up feat. Chloe Angelides
Robin Schulz - Yellow feat. Disciples
The Japanese House - Cool Blue
Fetty Wap - RGF Island
Zhu - Automatic feat. AlunaGeorge
Mac Miller - Weekend feat. Miguel
Transviolent - Night Vision
Great Good Fine Ok - Take It or Leave It
Robert DeLong - Jealousy
The Chainsmokers - Until You Were Gone feat. Tritonal & Emily Warren
A-Trak - We All Fall Down feat. Jamie Lidell
Disclosure - Jaded
Lana Del Rey - Freak
Ryan Adams - Bad Blood
Meg Myers - Sorry
Jasmine Thompson - Crystal Heart
The Banners - Shine a Light
Steven A. Clark - Lonely Roller
RHODES - You & I
BØRNS - Fool
Cameron James - All Out War
Lady Gaga - Til It Happens to You
Andy Mineo - Know That's Right
Naughty Boy - Runnin' (Lose It All) feat. Beyoncé & Arrow Benjamin
Lostboycrow - Powers
Mac Miller - The Festival feat. Little Dragon
Tory Lanez - B.L.O.W
Pell - Café Du Monde
Angel Haze - Moonrise Kingdom
Secret Someones - Let You Go
Charley Marley - Bad Things with Jamaicans
YACHT - L.A. Plays Itself
Kyla La Grange - So Sweet
Firekid - Lay by Me
5 Seconds of Summer - Money
Shinedown - How Did You Love
Metric - Too Bad, So Sad
Wolf Alice - Bros (Live from Spotify London)
The Front Bottoms - HELP
Deerhunter - Breaker
Maritime - Roaming Empire
The Sheepdogs - Take a Trip
David Gilmour - In Any Tongue
Guy Garvey - Angela's Eyes
Kisses - The Nile
Telekinesis - Dirty Thing
Telekinesis - Sylvia
Erik Hassle - Natural Born LoversEmbed