New Music Friday 04/19/19 LyricsSZA - Power is Power (feat. SZA, The Weeknd, Travis Scott) - from For The Throne (Music Inspired by the HBO Series Game of Thrones)
Beyoncé - Before I Let Go - Homecoming Live Bonus Track
Kygo - Carry On
French Montana - Slide (feat. Blueface & Lil Tjay)
Madonna - Medellín (with Maluma)
Lil Dicky - Earth
Lizzo - Soulmate
Beck - Saw Lightning
The Boyboy West Coast - U Was At The Club (Bottoms Up)
Beyoncé - I Been On - Homecoming Live
Daddy Yankee - Con Calma - Remix
Aries - BAD NEWS
Carly Rae Jepsen - Julien
Four Tet - Teenage Birdsong
Salvatore Ganacci - Horse
Jaden - Beautiful Disruption
Flipp Dinero - If I Tell You
Jeremy Zucker - you were good to me
Thomas Rhett - Remember You Young
0171 - SMTHN RL
Pedro Capó - Calma - Alicia Remix
Cage The Elephant - Social Cues
Tyga - Goddamn
Chris Brown - Wobble Up (feat. Nicki Minaj & G-Eazy)
Becky G - La Respuesta
Jade Bird - Side Effects
Kevin Abstract - Baby Boy
Blake Rose - Best of Me
Alice Gray - Take Me to the Water
Zack Martino & Dyson - Mood
Kevin Morby - OMG Rock n Roll
Lolo Zouaï - Caffeine
No Rome - Cashmoney
X Ambassadors - HEY CHILD
Why Don't We - Don't Change
daydream Masi - Nightlife
Christian Paul - Strong
Catfish and the Bottlemen - Conversation
Dinah Jane - Heard It All Before
Au/Ra - Assassin
HEALTH - JUDGEMENT NIGHT
Olivia O'Brien - Just A Boy
Shy Glizzy - Bang Bang (feat. YoungBoy Never Broke Again)
Lil Peep - Star Shopping
ARTY - Avalanche
Ty James - Temptations
Jon Bellion - Heart Is Full - Recorded At Spotify Studios NYC
Octavian - Lit (feat. A$AP Ferg)
Hit-Boy - Family Not A Group
03 Greedo - Visions
Kash Doll - Hustla
Fitz and The Tantrums - Don't Ever Let Em
Sophia Scott - Drink Too Much Wine
Kelsey Lu - Foreign Car
Steve Aoki - Do It Again
Rotimi - Love Riddim
Jain - Gloria
Slow Pulp - High
Ross Copperman - Stars Are on Your Side
Christian French - breaking all the rules
ROMderful - 1 Missed Call
Tycho - Easy
Giant Rooks - 100 mg
Pivot Gang - Colbert
Modest Mouse - I'm Still Here
Gus Dapperton - Coax & Botany
Tech N9ne - Like I Ain't
The Vamps - Missing You
SYML - Bed
Loyle Carner - Angel
lilbootycall - Mariah
24hrs - Back Out (feat. Ty Dolla $ign & Dom Kennedy)
Sech - Otro Trago
Sheryl Crow - Redemption Day
Mat Kerekes - Autumn Dress
Liss - Talk to Me
Black Pumas - Colors
Kurt Vile - No Expectations - Recorded at Spotify Studios NYC
Tee Grizzley - God's Warrior
Two Friends - Dollar Menu (feat. Dani Poppitt)
Phangs - Au Revoir
Wingtip - Broken Bones
Jordyn Jones - think about u
Blossoms - I've Seen The Future
Divino Niño - Maria
Lizzy Land - Call Me
Darell - Fumeteo
Studio Black - On Your Own (feat. Dolapo)
Delilah Montagu - Temptation
Injury Reserve - Koruna & Lime
JD McCrary - Stole My Heart
Doc Robinson - Mt Hood
Devvon Terrell - Power Of 10
Donae'o - The Party's Over Here
Argonaut & Wasp - Composure
PLTS - Young Ones
Adam Sample - Not Tonight
The Dangerous Summer - Way DownEmbed