New Music Friday 6/18/21 LyricsTyler, The Creator - LUMBERJACK
DaBaby - Ball If I Want To
H.E.R. - Paradise (feat. Yung Bleu)
Griff - Shade of Yellow
Migos - How Did I
Don Toliver - Drugs N Hella Melodies (feat. Kali Uchis)
Leon Bridges - Why Don't You Touch Me
Mabel - Let Them Know
Gucci Mane - Posse on Bouldercrest (feat. Pooh Shiesty & Sir Mix-A-Lot)
Little Simz - Rollin Stone
Diana Ross - Thank You
D-Nice - Rather Be (with Kiana LedÃ©) ğŸ•’
Logic - Intro
Wale - Angles (feat. Chris Brown)
KSI - Holiday
Vince Staples - LAW OF AVERAGES
Travie McCoy - A Spoonful of Cinnamon
Offset - Hit Em Hard
GoldLink - Raindrops (feat. Flo Milli)
Amenazzy - Rapido
Yxng Bane - Birthday (feat. StĞµfflon Don)
Isaiah Rashad - Headshots (4r Da Locals)
Jacquees - Bed Friend (fĞµat. Queen Naija)
TSHA - OnlyL
Blanco Brown - Nobody's More Country ğŸ•’
Jennifer Hudson - Here I Am (Singing My Way Home) ğŸ•’
Yves Tumor - Jackie
Young Dolph - Nothing To Me
Jenevieve - Midnight Charm
Twin Shadow - Sugarcane ğŸ•’
Amythyst Kiah - Tender Organs
James Fauntleroy - Feel
Cordae - What's Life - From "Liberated / Music For the Movement Vol. 3"
Jelani Aryeh - Overexposed
Emanuel - Hindsight
Serena Isioma - HUH?
Angelique Kidjo - Flying High ğŸ•’
Idris Elba - Fudge ğŸ•’
Raleigh Ritchie - Iâ€™m Not Okay But I Know Iâ€™m Going To Be
Dua Saleh - macrodosing - Spotify Singles
Unfoonk - Running Out of Patience (feat. Future)
DE'WAYNE - Super 8
Snoozegod - Late Night Drive
Shungudzo - Already free ğŸ•’
Marzz - Love Letter
V!ctoria - Petrichor
Shy Carter - Beer With My Friends (feat. Cole Swindell and David Lee Murphy) ğŸ•’
ASHER - say it back
Rejjie Snow - Disco Pantz
ChlÃ¶e - Feeling Good - From "Liberated / Music For the Movement Vol. 3"
Brittney Spencer - Sober & Skinny
Young Devyn - Like This
Zilo - I'm Sorry
rum.gold - Greed ğŸ•’
FN DaDealer - I Remember ğŸ•’
Shea Diamond - Smile
Tom Morello - Lightning Over Mexico ğŸ•’
M1llionz - Bando Spot
DonMonique - Paid n Full
Dave B. - All Falls Down ğŸ•’
Doe Boy - Shmurda Talk (feat. Rowdy Rebel)
Boslen - QUARTZ (feat. Charmaine)
Kyle Lux - I Went Out
Cameron Forbes - If I Was White
Dana Vaughns - Passionate ğŸ•’
Mykki Blanco - It's Not My Choice
Jerome Thomas - Secret
Sabina Ddumba - Coast (feat. Cherrie) ğŸ•’
Saucy Santana - Here We Go
BERWYN - TO BE LOVED
Shermanology - Let's Talk About
Mariah the Scientist - 2 You
Hope Tala - Mad
Big Yavo - Hotbox - Remix ğŸ•’
OMB Bloodbath - Don't Do It ğŸ•’
Lazarus Lynch - Black Queer Anthem
Benjamin Carter - Time Again
boyband - birth by sleep
Aaron May - No Excuses (Freestyle)
Joy Crookes - Feet Don't Fail Me Now
JON VINYL - Stacy ğŸ•’
Mia Ariannaa - CMR
Dee Watkins - 3 Phones ğŸ•’
Kojey Radical - 2FS
Amenazzy - Miedo
Naomi Sharon - Daughter Of The Sun ğŸ•’
CeeLo Green - Baby Don't You Go Go
Terrell Hines - Radon Dungeon
Olamide - Somebody (feat. Phyno)
Todd Terry - To da Breakdown
Aluna - Don't Hit My Line
Cookiee Kawaii - Press Play (Gamer Girl)
Ten City - Judgement
Tasha Cobbs Leonard - Gotta Believe
Brian Courtney Wilson - Be Real Black For Me
Lido Pimienta - Declare Independence - Spotify Singles
Dee Gatti - Must Be Something ğŸ•’
Steven Malcolm - Ãndale ğŸ•’
Chris Marshall - Bounce Wid It
Ir Sais - TropicalEmbed