New Music Friday 2/21/20 LyricsThe Weeknd - After Hours
Selena Gomez - Feel Me
Trippie Redd - The Way
YoungBoy Never Broke Again - Red Eye
5 Seconds of Summer - Old Me
Lauv - Modern Loneliness
Oliver Malcolm - Switched Up
Grimes - You'll miss me when I'm not around
Ozzy Osbourne - It's A Raid (feat. Post Malone)
The 1975 - The Birthday Party
Jimmie Allen - This is Us
KYLE - YES! (feat. Rich The Kid & K CAMP)
REI AMI - RUNAWAY
Gracie Abrams - 21
Kyle Dion - Play Too Much
Arizona Zervas - ROXANNE - Remix
Tainy - NADA (with Lauren Jauregui & C. Tangana)
Jax Jones - Tequila - Jax Jones & Martin Solveig Present Europa
Kamaiyah - Pressure
The Strokes - Bad Decisions
Kenny Chesney - Here And Now
Allie X - Susie Save Your Love
Mallory Merk - Ghosts
Glass Animals - Your Love (Déjà Vu)
Calboy - Givenchy Kickin (feat. Lil Baby & Lil Tjay)
Rick Ross - Season Ticket Holder (feat. D. Wade, Raphael Saadiq & UD)
NGHTMRE - Wrist
Sebastian Yatra - Seremos Campeones
Pearl Jam - Superblood Wolfmoon
Isaac Dunbar - makeup drawer
haroinfather - Ramona Flowers
Big Freedia - Chasing Rainbows (feat. Kesha)
G Herbo - Shooter
CHIKA - Industry Games
Rema - Beamer (Bad Boys)
[DJ Snake - No Option (feat. Burna Boy) - KIYA Remix] 🐚
The Avalanches - We Will Always Love You (feat. Blood Orange)
Blacc Zacc - Make A Sale (with Moneybagg Yo)
Fredo Bang - Yo Slime
Michi - Night Moves
Banoffee - One Night Stand
Jack Curley - Wait For Me
John K - 6 months
X Ambassadors - Great Unknown - From The Motion Picture “The Call Of The Wild"
COIN - Into My Arms
ceo@business.net - out of control
Yella Beezy - Keep It In The Streets
Street Bud - Open House (feat. Quavo)
[Yung Mal - Bachelor] 🐚
Moses Sumney - Neither/Nor
Purity Ring - stardew
Patrick Droney - The Wire
Mt. Joy - Strangers
Elohim - Group Therapy
Yoste - You Can't Fix Me
Afrojack - All Night (feat. Ally Brooke)
TOKiMONSTA - One Day
Omarion - Can You Hear Me? (feat. T-Pain)
Royce Da 5'9" - Tricked
UnoTheActivist - Can't Go (feat. Ty Dolla $ign)
Thundercat - Dragonball Durag
chloe moriondo - Ghost Adventure Spirit Orb
[Blakey - Confidant] 🐚
[Earth2Boy - Twinkle] 🐚
[iamnotshane - Right Now] 🐚
Ne-Yo - Pinky Ring (feat. O.T. Genasis)
Lil Gotit - Free Melly (feat. Polo G)

[Smoove'L - 2020] 🐚
[JAHMED - FIAT] 🐚
Giveon - HEARTBREAK ANNIVERSARY
Dua Saleh - mOth
[Maggie Miles - WHATDOISAY?] 🐚
Greyson Chance - Dancing Next To Me
JP Cooper - Bits and Pieces
[Frank Walker - Can't Let Go (feat. Harry Hudson)] 🐚
Aitch - MICE
[OMB Peezy - Let Up] 🐚
Seb Torgus - Darkside
Call Me Loop - Downhill From Here
JC Stewart - Lying That You Love Me
Emily Burns - Hello
Waxahatchee - Lilacs
King Krule - Cellular
Yves Tumor - Gospel For A New Century
Oklou - entertnmnt
Biffy Clyro - Instant History - Single Version
[Gerardo Ortiz - Otra Borrachera] 🐚
[ONR - Sober (feat. Carina Jade)] 🐚
[Emmi Elliott - Face to Face] 🐚
Caylee Hammack - Small Town Hypocrite
Orla Gartland - oh GOD
Kota the Friend - California
Kodie Shane - NOT TONIGHT
[Angelica Vila - Why feat. Jacquees] 🐚
Chris Malinchak - Somebody
Livingston - Fairytale
Best Coast - Master Of My Own MindEmbed