New Music Friday 12/25/20 LyricsSlay3r - Playboi Carti
Afterglow - Ed Sheeran
Good Days - SZA
Still Trappin' (with King Von) - Lil Durk
cheers (with Wiz Khalifa) - blackbear
Hearts on Fire - ILLENIUM
M3tamorphosis (feat. Kid Cudi) - Playboi Carti
Protect - NLE Choppa
Having a Good Time, Sometimes - Bakar
let all the poisons that lurk in the mud seep out - Kelsey Lu
My Play - AJR
Roommates - Dixie D’Amelio
Houdini - Dro Kenji
Flags - Coldplay
1000 Miles From Georgia - Kidd G
Laugh A Little - TheHxliday
Second Chance - Johnny 2 Phones
i love you baby - Emilee
It’s Not You It’s Me - EBEN
Mud Baby - Popp Hunna
Whole Lotta Liquor (feat. Future & PARTYNEXTDOOR) - Rubi Rose
Marinate - Zack Fox
Parallel 4 - Four Tet
she's watching - insha
Go2DaMoon (feat. Kanye West) - Playboi Carti
Amén - Ricardo Montaner
Long Live Cowboys - Aaron Watson
Growin' Up - acoustic at home - Eddie Vеdder
I Don't Mind - chlothegod
Dreamland - Morray
MODO TURBO - Luísa Sonza
Libеrty Bell - DARKSIDE
Do You Understand (What Has Happened to You) - Slaughter Beach, Dog
Morning Bells - Hether
Paradise - Faime
Bottom Bitch - Tink
Beautiful - Jay Sean
En un Rinconcito - A.C.O
Small Plastic Heart - Elder Island
In Case U Wanna Come Back - bby ivy
Signed with Love - Jay Critch
BAD ADVICE - DREJ
No Angel - Oliver Francis
Doing Great - Jasimi
Cuando Te Vi - Greeicy
Street Niggaz (feat. Big Unc Montana) - Hustler E
December 24th (feat. Elbee Thrie) - Nyck Caution
Just Buried! - iamnotshane
Memories We Can't Make - Angus Maude
when boys cry - at jimmy
Why so Serious? - Kyan Palmer
Don't Stop Me Eatin' - Duet - LadBaby
EightyHD - Chris Webby
Workin - YSN
Oh Baby Oh Baby - Borgeous
Was I Unkind? - Another Sky
Feminine Walk - Aaron Lee Tasjan
FWB - Sipper
Laptop - YOUTH 83
Ricochet - Griffin Stoller
WISH I WAS DEAD - Brandon ThaKidd
XXX - Pretty Sister
Haircut - Chaz Cardigan
I See You - Adam Turley
2021 - Slater Davis
Fake Friends - Katya Mila
Amusement Park - BAEKHYUN
Not Enough - Blackcode
if i get lost - Rayless
80 Proof - Eric Reprid
i think i got a crush - omgkirby
I hope that u think of me - Pity Party (Girls Club)
Life Is Good - WAMI
Just Call My Name - Mýa
We Can't Stop Loving - Twan Ray
I Forget - Austin Giorgio
Show You Love - Local Opener
No Shade - BLACKVVANA
Leave You - BEBURI
MoonCastle - MedizenKid
Different - Cade Flowers
Again - Lucys
Silk Print - Puma Blue
Andvevarljod - Wardruna
Chemz - BurialEmbed