New Music Friday 9/24/21 LyricsColdplay - My Universe
Giveon - For Tonight
YoungBoy Never Broke Again - No Where
Gunna - Too Easy
KAROL G - SEJODIOTO
Zoe Wees - That‚Äôs How It Goes (feat. 6LACK)
Elton John - After All
Joyner Lucas - Your Heart
Moneybagg Yo - Wockesha (with Lil Wayne & Ashanti) - Remix
bbno$ - i remember
G-Eazy - Faithful (feat. Marc E. Bassy)
Lucky Daye - Over
Latto - Big Energy
BIA - BESITO (feat. G Herbo)
Coi Leray - TWINNEM
Griff - Solar Power - Spotify Singles
Mickey Guyton - Lay It On Me
Alessia Cara - Best Days
EKKSTACY - it only gets worse, i promise
R√úF√úS DU SOL - On My Knees
Natti Natasha - Imposible Amor
James Blake - Hope She'll B–µ Happier - Spotify Singles
FINNEAS - A Little Clos–µr (FINNEAS Version) - From The ‚ÄúDear Evan Hansen‚Äù Original Motion Picture Soundtrack
The Lumineers - BRIGHTSIDE
Myke Towers - Experimento
ROLE MODEL - death wish
Trevor Daniel - Alone
Lakeyah - In Person (feat. OG Parker, Tyga)
reggie - Avalanche
Montell Fish - Wings
KIRBY - Can We Be Friends?
Ben B√∂hmer - Home
James Arthur - Emily
JESSIA - First Call
Whitney Houston - How Will I Know
Alina Baraz - If You Let Me
Morray - Bad Situations
Payday - Vampire (feat. Danny Brown)
Princess Nokia - Boys Are From Mars (feat. Yung Baby Tate)
Aitch - Party Round My Place (feat. Avelino & Toddla T)
Disclosure - Observer Effect
Nina Nesbitt - Life's a Bitch (L.A.B)
Harley Alaska - Lose You Too
X Ambassadors - Beautiful Liar
RaeLynn - Get That All The Time (feat. Mitchell Tenpenny)
Kidd G - Down Home Boy
alt-J - U&ME
Sufjan Stevens - It‚Äôs Your Own Body And Mind
Amber Mark - What It Is
Sheff G - Drum Dummy
Bankrol Hayden - Come Through (feat. Lil Tecca)
MASN - Strawberry Huracan
Amy Allen - A Woman's World
Daya - What If I Told You (Original Music from The L Word: Generation Q)
Matteo Bocelli - Solo
Ne-Yo - What If
Don Omar - Flow HP
Remble - Rocc Climbing (feat. Lil Yachty)
Co Cash - HIM (feat. Yo Gotti) üïí
Kari Faux - Chattin' Shit
Paris Texas - girls like drugs
mehro - howling
Chloe George - Peachi
Nao - Burn Out
Godford - Say My Name
Two Friends - Love Love
ITZY - LOCO
L Devine - Die On The Dancefloor
Lourdiz - Get Along (feat. Shenseea)
Wisin - Emojis de Corazones (feat. Los Legendarios)
D Smoke - Good Thing
22Gz - Retaliation
Token - High Heels (feat. Rico Nasty)
midwxst - LA (feat. KA$HDAMI)
Sans Soucis - Games
Gabriels - Blame
Oh Wonder - 22 Break
Ant Saunders - All Damn Day!
AVIV - love of your life
Pia Mia - Only One üêö
Lola Young - FAKE
Boys Noize - Affection
UNIIQU3 - Unavailable üïí
Georgia Greene - Have You Thought About Me With Somebody Else
Wrabel - wish you well
Wabie - Holly Holly üêö
The Regrettes - Monday
Cold War Kids - I Can't Walk Away
Parquet Courts - Black Widow Spider
Tom Morello - Let‚Äôs Get The Party Started (feat. Bring Me The Horizon)
The Score - Pull The Cord
Billy Strings - Heartbeat Of America
Lime Cordiale - Apple Crumble
The Greeting Committee - Make Out
Alt Bloom - High School
Dora Jar - Scab Song
a kid named rufus - i feel good sometimes
Neptune - Strawberry Lemonade
Badflower - Only Love
Guns N' Roses - Hard SkoolEmbed