New Music Friday 02/08/19 LyricsKhalid - Talk
Ariana Grande - break up with your girlfriend, i'm bored
Ariana Grande - bad idea
The Chainsmokers - Who Do You Love (with 5 Seconds of Summer)
Aminé - BLACKJACK (feat. YBN Cordae) - Remix
Maren Morris - Common (feat. Brandi Carlile)
Blake Rose - Lost
Anna Of The North - Leaning On Myself
Quinn XCII - Holding Hands (feat. Elohim)
Ariana Grande - NASA
Lucky Daye - Real Games
Dermot Kennedy - Lost
David Guetta - Better When You're Gone
Avonlea - Stranger
Lil Durk - No Label
Mahalia - Do Not Disturb
Shy Girls - Lay And Be Lonely
Diplo - New Shapes
Henry Jamison - True North
Florida Georgia Line - Y’all Boys
Barrie - Clovers
Cuco - Fix Me
Kim Petras - 1,2,3 dayz up (feat. SOPHIE)
Buddy - Link Up (feat. Kent Jamz, Bas, Guapdad 4000 & J.I.D)
Gary Clark Jr. - Pearl Cadillac
Bibio - Curls
EARTHGANG - Proud Of U (feat. Young Thug)
H.E.R. - Think (From the Motion Picture "What Men Want")
KIAN - Childism
Meghan Trainor - FOOLISH
Marshmello - Sell Out
Alejandro Sanz - Back In The City
Comethazine - Boy Don't Cap!
Roy Woods - Worth It
Nick Mulvey - Moment Of Surrender
Moby Rich - Blink
Hounded - Hollow
Cheat Codes - Ferrari (feat. Afrojack)
Q Money - Neat (feat. Young Dolph, YFN Lucci, Peewee Longway, Flipp Dinero & G Herbo) - Remix
RL Grime - Arcus
Mercury Rev - Jesseye' Lisabeth
Ed Sheeran - Shape of You  - Recorded at Spotify Studios NYC
Darell - Caliente
Caravan Palace - Miracle
Jubël - Teenage Minds
Odunsi (The Engine) - Tipsy (feat. RAYE)
Svrcina - Insecure
Kelly Rowland - Crown
Sofia Karlberg - Spotless Mind
Austin Mahone - Why Don't We
R3HAB - This Is How We Party (with Icona Pop)
Hardwell - Chase The Sun
Trey Songz - Chi Chi (feat. Chris Brown)
MARINA - Handmade Heaven
Quintino - Can't Bring Me Down
Mahalo - Go Ahead
Tony Bennett - Love Is Here To Stay - Recorded At Spotify Studios NYC
Laura Stevenson - Living Room, NY
Above & Beyond - Distorted Truth
James Gardin - Chitown Boogie
The Japanese House - We Talk all the Time
Peach Tree Rascals - Plus
Mark Diamond - Road
EMMA WAHLIN - Make A Move
Sick Individuals - SCARS (feat. Cub Rayan)
Vera Blue - Like I Remember You
Elohim - TV
Conan Gray - The Other Side
Chris Janson - Good Vibes
Greyson Chance - shut up
i_o - Let Me Go
The Amazons - Mother
Meg Mac - Something Tells Me
Ocean Park Standoff - Good Time
Mat Kerekes - Ruby
Panda Bear - Buoys
Rilès - Marijuana
Walking On Cars - Coldest Water
Jamila Woods - ZORA
Gerard Way - Happy Together (feat. Ray Toro)
Esteman - Solo
adam&steve - wherever you are
Matrix & Futurebound - Got You There
Hollyn - Good Times
Ben Kweller - Heart Attack Kid
Y La Bamba - My Death
HEALTH - STRANGE DAYS (1999)
Jutes - Devil
Armors - Portland
Baker Grace - Wrong Kind Of People
Emarosa - Get Back Up
Myles Cameron - Yellow
Leah Nobel - Truly Known
Benjamin Rihan - Dizzy Talk
Jesse Mac Cormack - No Love Go
Velvet Two Stripes - Gypsy
Adam Melchor - Three Hours Ahead
Seaside - HabitsEmbed