New Music Friday 11/22/19 LyricsLewis Capaldi - Before You Go
Stormzy - Own It (feat. Ed Sheeran & Burna Boy)
Harry Styles - Watermelon Sugar
PARTYNEXTDOOR - Loyal (feat. Drake)
Trippie Redd - Who Needs Love
Coldplay - Champion Of The World
Maggie Rogers - Love You For A Long Time
Summer Walker - Something Real (with London On Da Track & Chris Brown)
Mark Ronson - Then There Were Two
Bad Bunny - Vete
Kesha - My Own Dance
beabadoobee - Don't You (Forget About Me) [Live from Abbey Road Studios, London]
HAIM - Hallelujah
Gracie Abrams - Stay
XXXTENTACION - bad vibes forever
Alicia Keys - Time Machine
DaVido - D & G (feat. Summer Walker)
David Guetta - Make It To Heaven (with Raye)
Labrinth - Oblivion (feat. Sia)
U2 - Ahimsa
Beck - Chemical
Ozzy Osbourne - Straight to Hell
Lolo Zouaï - Money Diamonds Roses
24kGoldn - DROPPED OUTTA COLLEGE
Tinashe - Save Room for Us
Grace VanderWaal - Poser
X Lovers - Cut My Lip
Dennis Lloyd - Unfaithful
Taylor Janzen - What I Do...
Zero 9:36 - Come Thru
Jason Aldean - Tattoos and Tequila
A Great Big World - Fall On Me
Nina Nesbitt - Still Waiting to Start
Spencer Barnett - I'm Fine
Johan Lenox - no one wants to dance anymore (feat. Yung Pinch)
Deaton Chris Anthony - Late Night Lovin' (feat. Omar Apollo, Jean Dawson & Korbin In Orbit)
Smokepurpp - Dirty Dirty (feat. Lil Skies)
Ciara - Melanin (feat. Lupita Nyong'o, Ester Dean, City Girls, & LA LA)
Juanes - Tequila
Alok - On & On
Ekali - Hard To Say Goodbye (feat. Chloe Angelides)
Lola Young - Blind Love
Adam Melchor - I CHOOSE YOU
Elah Hale - Posters
ALMA - Bad News Baby
03 Greedo - Disco Shit
Flipp Dinero - Westside
CHIKA - Can't Explain It (feat. Charlie Wilson)
Big Freedia - Louder (feat. Icona Pop)
AJ Mitchell - Unstoppable
Carlie Hanson - Side Effects
Stephen Puth - Crying My Eyes Out
Prince Fox - Same Love
Scarypoolparty - Millennial Love
Nasty Cherry - Fuck Modern Love
Des Rocs - Give Me the Night
MfnMelo - What a Life
Blac Youngsta - Like A Pro (feat. DaBaby)
Only The Family - Blika Blika
SKYXXX - Chicken Dinner
Mr Eazi - Tony Montana
Felix Jaehn - Close Your Eyes
Hannah Diamond - The Ending
Phangs - I Forgot You
Jessie J - One More Try
MIA GLADSTONE - GEEKIN
Terrace Martin - Intimidated
Jay Critch - Cameras
Casey Veggies - Big Racks (feat. Iamsu)
Farina - Así Así
ASTN - Ain't Dumb
Leyla Blue - I Don't Wanna Know
Emily Burns - Hate Me Too
Little Big Town - Sugar Coat
Filmore - London
The Who - I Don't Wanna Get Wise
Palaye Royale - Massacre, The New American Dream
DENM - Alright
L8LOOMER - shinelikewhoa
Fredo Bang - Mongoose (Fuck You)
Giveon - LIKE I WANT YOU
Ginger Root - B4
Christian Alexander - So High
Litany - Single Player Mode
Navvy - Scared to Be Happy
Delaney Jane - Circling The Cage
Alt Bloom - Stay
MKTO - Consider Me Yours
Tech N9ne - Angel Baby
Lil Poppa - On My Own
Mozzy - Everybody On Go
Taliwhoah - Sweet Sweet
SAYGRACE - Doin' Too Much
The Japanese House - Chewing Cotton Wool
Pouya - life? ... lol
Black Caviar - Kubrick Faked The Moon LandingEmbed