New Music Friday 10/28/22 LyricsRihanna - Lift Me Up
SZA - Shirt
Juice WRLD - In My Head
Fred again.. - Clara (the night is dark)
Kodak Black - 300 Blackout
Wizkid - Money & Love
Manuel Turizo - Ã‰xtasis
Dove Cameron - Bad Idea
Polo G - Bag Talk
Lainey Wilson - Hold My Halo
Montell Fish - Exscape
Yung Gravy - Dancing In The Rain
Isabel LaRosa - i'm yours
dvsn - Take It Slow
ChlÃ¶e - For the Night
Trippie Redd â€“ Ainâ€™t Safe (feat. Don Toliver)
Baby Keem - highway 95
Labrinth - Iridium
FousheÃ© - supernova
Ice Spice - Bikini Bottom
Smino - Pro Freak
Gryffin - Forever (feat. Elley DuhÃ©)
Benson Boone - Before You
UPSAHL - Into My Body
Holly Humberstone - Can You Afford To Lose Me?
Ski Mask The Slump God - OOGA BOOGA!
Black EyĞµd Peas - SIMPLY THE BEST
JIN - The Astronaut
Sam FendĞµr - Wild Grey Ocean
Chappell Roan - Casual
Royal & the Serpent - No Regrets
Tom Odell - Just Another Thing We Don't Talk About
Keith Urban - Street Called Main
Ruel - SOMEONE ELSE'S PROBLEM
Rachel Chinouriri â€“ Iâ€™m Not Perfect (But Iâ€™m Trying)
Cat Burns - American Boy - Spotify Singles
Ashanti - Falling For You
Riovaz - Tell Me Your Fears
Sherwyn - THE SEASON (feat. PawPaw Rod)ğŸš
Y2K - DIRT (feat. JPEGMAFIA) â˜‘ï¸
SleazyWorld Go - Glitches (feat. G Herbo)
Macklemore - FAITHFUL (feat. NLE Choppa)
DE'WAYNE â€“ SHEâ€™S MY (SEXI BOY)ğŸš
Sech - Foto En Panty
Mae Muller - I Just Came To Dance
charli d'amelio - if you ask me to
Clinton Kane - MEXICO
The Backseat Lovers - Snowbank Blues
Matt Maltese - Mother
Riton - Chale (feat. Clementine Douglas)
Zzz. - All I Never Wanted
Money Man - Similar ğŸš
RealestK - Divide
Leah Kate - Alive and Unwell
Dylan - Blisters
Grace Gardner - Deny Me ğŸš
Mariah the Scientist - Bout Mine
LIT killah - MAN$ION
BabyTron - Myspace
Morray - Letter To Myself
Westside Gunn - Shootouts In Soho (feat. A$AP Rocky & Stove God Cooks)
Gus Dapperton - Wet Cement
Daniel Leggs - runaway
Trampled by Turtles - Starting Over ğŸš
Iggy Pop - Frenzy ğŸš
Shania Twain - Last Day of Summer
Teddy Swims - Devil in a Dressâ˜‘ï¸
Christian French - karma
ella jane - Warhol
Emei - End of an Era
Jameson Rodgers - I'm on a Dirt Road ğŸš
Kaash Paige - Doubted Me
Eli Derby - good time
Quando Rondo - Cream Soda
IDK - Monsieur Dior
Kordhell - I FEEL ALIVE
Kailee Morgue - Falling from the Sky
Anyma - The Sign
Maya Delilah - Pretty Face
Keni - Come Back ğŸš
The South Hill Experiment - Chameleons ğŸš
White Reaper - Pages ğŸš
Killer Mike - TALK'N THAT SHIT!
BlueBucksClan - Let Me Know (feat. Jeremih) ğŸš
Duke Deuce - MR MEMPHIS MASSACRE ğŸš
DRAM - PPL
Limoblaze - Pull Up ğŸš
TAELA - Good In Bed ğŸš
girlpuppy â€“ Permanent State ğŸš
Drugdealer - Baby ğŸš
Old Sea Brigade - If Youâ€™re Falling Asleep
Levi Hummon - RSVP
Leven Kali - TEARS OF JOY ğŸš
Reyna Roberts - Pretty Little Devils ğŸš
Lola Marsh - Shot Shot Cherry ğŸš
Rose Betts - Alone in an Uber ğŸš
RINI - Haunt Me
Manana - Inside ğŸš
Flatland Cavalry - Parallel
Nuclear Daisies - Hush ğŸšEmbed