New Music Tuesday 05/05/15 LyricsTech N9ne feat. Eminem & Krizz Kaliko - Speedom (Wwc2)
Miguel feat. Wale - Coffee
Cheat Codes feat. Lostboycrow - Senses
Britney Spears & Iggy Azalea - Pretty Girls
Disclosure - Bang That
Alessia Cara - Here
Mumford & Sons - Wilder Mind
Best Coast - Feeling Ok
Brandon Flowers - I Can Change
Life in Film - Anna, Please Don't Go
My Morning Jacket - Compound Fracture
Tame Impala - Disciples
Snoop Dogg feat. Stevie Wonder - California Roll
Twenty One Pilots - Lane Boy
Ciara feat. Pitbull & Missy Elliot - That's How I'm Feelin'
Avicii - Feeling Good
Charlie Puth - I Won't Tell a Soul
Elijah Blake - Everyday
Shamir - Darker
Little Boots - Better in the Morning
Jamie Foxx feat. Kid Ink - Baby's in Love
Avery Wilson - If I Have To
Pia Mia feat. Chris Brown & Tyga - Do It Again
Whilk & Misky - Burn With Me
Zella Day - High
Aquilo - Put Me Down
The Hearts - Run Free
Oh Wonder - Livewire
The Helio Sequence - Upward Mobility
The Moth & The Flame - Young & Unafraid
Arty - Stronger
Highly Suspect feat. Sasha Dobson - 23
Syn Cole - It's You (Broiler Remix)
Alesso - If It Wasn't For You
Fetty Wap feat. Quavo & Gucci Mane - Trap Queen
Mila J feat. Ty Dolla $ign - My Main (KickRaux & Walshy Fire Remix)
Parade of Lights - Feeling Electric
Luxley feat. Nora Patterson - Spirit (Great Good Fine OK Remix)
MADE IN HEIGHTS - Slow Burn
Lyves X Synkro - Body Close
Penguin Prison - Try to Lose
Cayucas - Moony Eyed Walrus
Django Django - Beginning to Fade
Mumford & Sons - Only Love
Pale Honey - Over Your Head
Titus Andronicus - Dimed Out
The Chemical Brothers - Go
ISHi feat. Astrid S - Dawn
Metz - Acetate
Torres - Cowboy Guilt
Leon Bridges - River
Mandolin Orange - Little Worlds
Mac McCaughan - Your HologramEmbed