New Music Friday 06/22/18 LyricsG-Eazy - Drop
Ariana Grande - the light is coming (feat. Nicki Minaj)
Panic! At The Disco - Dancing's Not A Crime
Bebe Rexha - Self Control
Meek Mill - Stay Woke (feat. Miguel)
Juice WRLD - Legends
Paul McCartney - Come On To Me
Jaden Smith - GHOST
Cheat Codes - Only You
Alec Benjamin - The Boy In The Bubble
6LACK - Switch
Toby Green - Ready
Dan + Shay - What Keeps You Up At Night
Marshmello - Rooftops
Robin Schulz - Oh Child
Trippie Redd - Me Likey
PRETTYMUCH - Summer on You
NEIKED - Old School Love
Jack River - Confess
Meghan Trainor - ALL THE WAYS
Charlotte Lawrence - I Bet
Wiz Khalifa - Hopeless Romantic (feat. Swae Lee)
NF - WHY
Tash Sultana - Salvation
Bryce Vine - On the Ball
Lecrae - 2 Sides Of The Game
Jax Jones - Ring Ring (feat. Mabel & Rich The Kid)
Daya - Safe
Chris Lane - Drunk People
R3HAB - Wrong Move
KAWALA - Mighty River
Amy Shark - Psycho
Gallant - Doesn't Matter (feat. A$AP Ferg)
Real Friends - Smiling On The Surface
St. Lucia - A Brighter Love - Edit
Cardi B - I Like It - Dillon Francis Remix
Yellow Claw - Another Life
Wet - You're Not Wrong
Fuego - Como Yo
Buddy - Hey Up There
G Herbo - Swervo
COTIS - All Night
A Boogie Wit da Hoodie - Pretending (feat. Jessie Reyez)
Years & Years - Palo Santo
Tory Lanez - Talk To Me (with Rich The Kid)
Paul McCartney - I Don't Know
Florence + The Machine - Big God
Michael Brun - Soweto
Stars Go Dim - Pieces
Gorillaz - Hollywood (feat. Snoop Dogg & Jamie Principle)
Aaron Taos - Voodoo
Goody Grace - Judas
Code Orange - The Hunt (feat. Corey Taylor)
Ashe - Real Love
Joy Oladokun - Sober
The Love Language - New Amsterdam
Nine Inch Nails - Ahead of Ourselves
The O'My's - Starship
Rakim - King's Paradise
Gryffin - Just For A Moment (feat. Iselin)
Peter CottonTale - Forever Always
Rick Ross - Green Gucci Suit
DJ Snake - Let's Get Ill
Elley Duhé - LOST MY MIND
Jacob Sartorius - Hooked On A Feeling
GIVERS - Love Is Like A Fire
MorMor - Find Colour
Kevin George - She Don't Love Me
Dillon Francis - Look At That Butt
Billy Raffoul - 1975
Demi Lovato - Sober
Ryan Beatty - Camo
Nora Van Elken - I Told You
Lizzo - Boys
Kamasi Washington - Street Fighter Mas
Miya Folick - Stock Image
JMSN - Talk Is Cheap
Skepta - Energy (Stay Far Away)
Kölsch - HAL
Iris Temple - Tear U Down
Spazz Cardigan - Nerves
London Richards - Fall Again
MONA - All I've Known
Sophie Simmons - Paper Cut
Cosmo's Midnight - Talk to Me
The New Respects - We Ain’t Goin’ Nowhere
LeAnn Rimes - Borrowed (Re-Imagined)
Glassio - New York, New York II
Natti Natasha - Quien Sabe
Kungs - Be Right Here
The White Panda - Hands On Me (feat. Loote)
The Last Artful, Dodgr - Win Is Enough
Brandi Carlile - Hallelujah - Recorded at Spotify Studios NYC
Tom Walker - My Way
AS IT IS - The Stigma (Boys Don’t Cry)
SLANG - Richest Man In The World
Charlie Heat - Celebrate Life
We The Kings - On My Love
Koryn Hawthorne - Down Goes Rome
Adam Beyer - Your MindEmbed