New Music Friday 03/11/22 LyricsMegan Thee Stallion - Sweetest Pie
Rex Orange County - OPEN A WINDOW (feat. Tyler, The Creator)
Florence + The Machine - My Love - Edit
Lil Durk - Petty Too (feat. Future)
Latto - Wheelie (feat. 21 Savage)
Imagine Dragons - Bones
Lucky Daye - Feels Like
Terry Presume - Don't Like U
The Chainsmokers - iPad
Maren Morris - Nervous
Rachel Chinouriri - All I Ever Asked
Luis Fonsi - Dolce
Takeoff - Crypto (feat. Rich The Kid)
Omar Apollo - Killing Me
FINNEAS - Flume - Spotify Singles
BRELAND - Praisе The Lord (feat. Thomas Rhett)
B-Lovee - Boom Boom (fеat. A Boogie Wit da Hoodie)
Shenseea - Can't Anymore
Claire Rosinkranz - stuck on us
YUNGBLUD - The Funeral
Ruel - LET THE GRASS GROW
Lexi Jayde - hate to be you
Marshmello - Before U
Mike Dimes - PAPARAZZI
Yuna - Pantone 17 13 30
chloe moriondo - sammy
The Black Keys - Wild Child
ERNEST - Classic
Kx5 - Escape (feat. Hayla)
Jhay Cortez - Sensual Bebé
Aitch - Baby
James Arthur - Losing You
Lyn Lapid - The Outsider
Mad Tsai - stupid games
Orville Peck - The Curse of the Blackened Eye
UMI - sorry
Aya Nakamura - Dégaine (feat. Damso)
NLE Choppa - The Gender Reveal Song
KayCyy - THE SUN (Prod. Gesaffelstein)
Whethan - Mental (feat. Slump6s & glaive)
Lil Mosey - Falling
tobi lou - 2hrs+ (feat. T-Pain)
KYLE - Carefree
MOD SUN - Rich Kids Ruin Everything
Jimmie Allen - Down Home
Miranda Lambert - Strange
Orion Sun - pressure
Ethel Cain - Everytime - Spotify Singles
Verzache - Broke Mine
Sean Paul - How We Do It (feat. Pia Mia)
Rema - FYN
Yella Beezy - Who Do
Kali - Standards
Mooski - Counting Time
Ravenna Golden - Big Knife
NOTD - about you
Sigrid - It Gets Dark
Bryce Vine - American Dream
John Summit - La Danza
Armin van Buuren - Love We Lost (with R3HAB)
Static & Ben El - Ziki Ziki (feat. Lil Baby, Snoop Dogg)
Fenix Flexin - Dead Homies
Stunna 4 Vegas - The One
Superorganism - Teenager
ASTN - Real
SUNMI - Oh Sorry Ya
Alison Wonderland - New Day
Ella Henderson - Ugly
Patrick Droney - All Loved Out
Father John Misty - Goodbye Mr. Blue
Felix Ames - SPF
Eli Derby - Lately (with 6LACK)
Tanna Leone - With The Villains
Bruses - Wannabe - Spotify Singles
Ben Rector - Sunday (feat. Snoop Dogg)
Ben Abraham - Another Falling Star
Michael Bublé - Higher
for KING & COUNTRY - Broken Halos
Caamp - Believe
BRS Kash - RBS (Rich Bish Shit)
Tailz. - Good Time
Justin Quiles - GUCCI FENDI
Andrekza - Oro Negro
FISHER - It's A Killa
INNA - Cryo
Kate Bollinger - Who Am I But Someone
Ego Ella May - Beautiful Days
Donzell Taggart - Flames
Boza - Tick Tock
Rexx Life Raj - Beauty In The Madness
Key Glock - Pain Killers
Benny The Butcher - 10 More Commandments (feat. Diddy)
Hether - underground pleasure
Milky Chance - Synchronize
Ghost - Watcher In The Sky
Nia Archives - Part Of Me
Leslie Grace - Un Buen Día
RYL0 - Broke Nobody
Daisy the Great - Cry in the Mirror
dayaway - cool waterEmbed