New Music Friday 12/25/15 LyricsDon Diablo & Khrebto - Got the Love
Flo Rida - Dirty Mind feat. Sam Martin
Mike Posner - Be As You Are (Jordon XL Remix)
Echos - All I Want
Dvsn - Hallucinations
I Am Karate - Bitter
Kid Ink - Promise feat. Fetty Wap
Alan Walker - Faded
Jetta - I'd Love to Change the World (Matstubs Remix)
Aeroplane Mode - Aphrodite
Tchami - Alone feat. Illangelo & Chuck Ellis
RAC - Magic Hour feat. Little Boots
Lewis Lane  - Take
Coyote Kisses - The Deep
Snoop Dogg - I'm From Long Beach
Fetty Wap - Merry Xmas feat. Monty
Wilde - 100 Days feat. The 25th Hour
Jidenna - Extraordinaire
Alvin Risk - Beastmode feat. Hodgy Beats
Diamond Eyes - U & I (Froogle Remix)
Tchami - Freakin feat. Dombresky
Photo Ops - Maybe We'll Change
LCD Soundsystem - Christmas Will Break Your Heart
Weekender - Floaty Feeling, Blue
Kevin Devine - No One Says You Have To
Rudimental  - Lay It All On Me (feat. Big Sean, Vic Mensa & Ed Sheeran) [Rudi VIP Mix]
Mac Irv - Kitchen feat. Tory Lanez
Dreezy - Nonstop
Lianne La Havas - Green & Gold (Donnie Trumpet & Nate Fox Remix)
Olivia Noelle - Faking It
Krrum - Morphine (Ben Baptie Remix)
Blended Babies - Dizzy Mornin'
Coheed and Cambria - Hello
Damien Jurado - Exit 353
Brian Fallon - A Wonderful Life
Blue House - Hot Air Balloons
KYTES - On the Run (Mount Remix)
Gnash - Tell Me It's Okay
Two Another - Higher
Oh, Be Clever - BlanketEmbed