New Music Friday 03/10/17 LyricsStargate - Waterfall feat. P!nk & Sia
Nicki Minaj, Drake & Lil Wayne - No Frauds
Aminé - REDMERCEDES
Lorde - Liability
Amir Obe - WISH YOU WELL
Vice - Obsession feat. Jon Bellion
Basic Tape - No Matter
2 Chainz - It's A Vibe feat. Ty Dolla $ign, Trey Songz & Jhene Aiko
Charli XCX - 3AM (Pull Up) feat. MØ
Astrid S - Breathe
Hey Violet - Break My Heart
Elle King - Wild Love
Pitbull & J Balvin - Hey Ma feat. Camila Cabello (Spanish Version)
Rick Ross - Trap Trap Trap feat. Young Thug & Wale
Yellow Claw - Stacks feat. Quavo, Tinie Tempah & Cesqeaux
Trey Songz - She Lovin It
K.Flay - High Enough
The Shins - Painting a Hole
Alt-J - 3WW
Judah & the Lion - Green Eyes
Laura Marling - Always This Way
Yoke Lore - World Wings
Colouring - Heathen
Fickle Friends - Hello Hello
MOD SUN - Spent All My Money... feat. Blackbear
A Boogie Wit da Hoodie - Drowning feat. Kodak Black
FLETCHER - Wasted Youth (Michael Brun Remix)
Brian Fresco - Higher feat. Chance The Rapper & Blue Hawaii
XYLØ - I Still Wait For You
A Great Big World - When I Was a Boy
COIN - Malibu 1992
Computer Games & Darren Criss - Lost Boys Life
Jon Bellion - All Time Low feat. Stormzy
Matoma & MAGIC! - Girl At Coachella feat. D.R.A.M.
James Blunt - Bartender
New Politics - One of Us
Milky Chance - Blossom
Wrabel - Bloodstain
Sha Leon - Where R U Gonna B?
Eric Bellinger - Treat Yourself feat. Wale
J.I.D - D/vision feat. EARTHGANG
GoldLink - Meditation feat. Jazmine Sullivan & KAYTRANADA
Smino - Father Son Holy Smoke
Gnash - i could change ur life
Charli XCX - Babygirl feat. Uffie
Little Mix - Touch feat. Kid Ink
Flor - hold on
Bush - All the Worlds Within You
Bantu - Roll With Me
Praything - You'll Be Mine
MiC LOWRY - Whiskey Kisses
Röyksopp - Never Ever feat. Susanne Sundfør (Yotto Remix)
Old Dominion - No Such Thing as a Broken Heart
Jordan Max - Out of Luck
Alyssa Micaela - Clean Break
Ryan Griffin - Woulda Left Me Too
Zac Brown Band - Real Thing
Fleet Foxes - Third of May / Ōdaigahara
Hurray For The Riff Raff - Living In The City
Jai Wolf - Like It's Over feat. MNDR (Howle Remix)
Mallory Knox - Wired
X Ambassadors - Hoping
Benjamin Booker - Witness
SoMo - Want It
Skylar Stecker - Only Want You
Pentatonix - Imagine
Leon Else - The City Don't Care feat. Oliver
Brayton Bowman - PUFF PUFF PASS REMIX feat. Kyle
Jorja Smith - Beautiful Little Fools
Brenda Mada - House Party
Playboi Carti - Lookin feat. Lil Uzi Vert
DJ Mustard - Want Her feat. Quavo & YG
La'Porsha Renae - Somebody Does
Louis Futon - Surreal feat. RKCB
Work Drugs - Giving up the FeelingEmbed