New Music Friday 6/4/21 LyricsBillie Eilish - Lost Cause
Lil Baby - Voice of the Heroes
Roddy Ricch - Late At Night
Bad Bunny - Yonaguni
John Mayer - Last Train Home
Calvin Harris - By Your Side (feat. Tom Grennan)
blackbear - u love u (with Tate McRae)
Remi Wolf - Liz
Yo Gotti - Drop (feat. DaBaby)
Meek Mill - Flamerz Flow
Moneybagg Yo - Rookie Of The Year
Masked Wolf - Gravity Glidin
Luis Fonsi - B√©same
BROCKHAMPTON - JEREMIAH - RMX
Gryffin - Best Is Yet To Come (with Kyle Reynolds)
Madison Beer - Reckless
Sleepy Hallow - Scrub
Rod Wave - Forever Set In Stone
Ty Dolla $ign - I Won
Joy Oladokun - taking the heat
jxdn - THINK ABOUT ME
JESSIA - I Should Quit
Marshmello - Hitta (feat. Juicy J)
Surf Mesa - Los–µ My Mind (feat. Bipolar Sunshine)
Jungle - Talk About It
Surfac–µs - So Far Away
BRELAND - Throw It Back
Cavetown - Idea of Her
Japanese Breakfast - Paprika
Payday - Ode To Soulja Girl (feat. AG Club)
Foushe√© - my slime
Paravi - Cloud 9
Dennis Lloyd - The Way
CHVRCHES - How Not To Drown (feat. Robert Smith)
Cautious Clay - Strange Love - Single Edit
H.E.R. - Change - from the Netflix Series "We The People"
Lucky Daye - Running Blind - From "Liberated / Music For the Movement Vol. 3"
21 Savage - BETRAYED
Cico P - Boogieee
OG Parker - Rain Down (feat. Latto & Layton Greene)
glaive - detest me
daine - dainecore
Wolf Alice - How Can I Make It OK?
Baby Queen - American Dream
Wallice - Dramamine
King Princess - House Burn Down
JP Saxe - More of You
b√ºlow - Revolver
Powfu - mario kart (feat. Travis Barker)
Polo & Pan - Tunnel üïí
ArrDee - Oliver Twist
Rich The Kid - Boss Bitch (feat. Coi Leray)
Belly - Zero Love (ft. Moneybagg Yo)
Becky G - Fulanito
Dillon Francis - Unconditional
Jessie Ware - Hot N Heavy
The Mar√≠as - Un Mill√≥n
Matt Maeson - Nelsonwood Lane
Brett Young - You Didn‚Äôt
Noah Schnacky - Don‚Äôt You Wanna Know
Hayley Kiyoko - Chance
L√òL√ò - die without u
Frances Forever - paranoia party
David Guetta - Impossible (feat. John Martin)
A7S - Nirvana
KA$HDAMI - Up!
Whookilledkenny - VANESSA üïí
KenTheMan - WTF üïí
Roy Woods - Touch You
Q - It Won't Get Ya üïí
San Holo - wheels up
Rise Against - Talking To Ourselves
cleopatrick - VICTORIA PARK
Sally Boy - Chess & Checkers
Andrew Jannakos - When the Whiskey Runs Out
Cynthia Erivo - The Good
Anthony Ramos - √âchale
Nobeat - Medio Crazy (with KHEA)
Peter Rosenberg - Snake Eyes (feat. Ghostface Killah, Crimeapple & Jim Jones) üêö
Tru Carr - Know Sumthin üïí
Foster - as long as i have you
renforshort - wannabe
Samia - Show Up
CAL - It's All Good
Lexi Jayde - bedroom walls
Royal & the Serpent - girls (feat. phem)
JUMEX - Internet Friends
Riley Clemmons - Headspace
TOMORROW X TOGETHER - Magic
Jax Jones - Feels
Alesso - TOGETHER
DARKSIDE - Lawmaker
Rostam - Starlight
Young Rog - Destiny üïí
Louie V Gutta - Big Dawg üêö
cupcakKe - Moonwalk
EMELINE - flowers & sex
Ashley Cooke - Under
Jake Wesley Rogers - Momentary
Atreyu - BaptizeEmbed