New Music Friday 01/05/18 LyricsJustin Timberlake - Filthy
Kendrick Lamar & SZA - All The Stars
Bruno Mars - Finesse (Remix) feat. Cardi B
Liam Payne & Rita Ora - For You (Fifty Shades Freed)
Soleima - Low Life
Charlie Puth - If You Leave Me Now feat. Boyz II Men
Lil Pump - Designer
Youngr - Ooh Lordy
Francis and the Lights - Just for Us
Superorganism - Everybody Wants To Be Famous
Breathe Carolina & Sunstars - DYSYLM
CupcakKe - Crayons
Au/Ra - Outsiders - Acoustic
Anderson East - Girlfriend
Kid Ink - Tell Somebody
Tonight Alive - Disappear feat. Lynn Gunn
BØRNS & Lana Del Rey - God Save Our Young Blood
A Perfect Circle - Disillusioned
Ekali & ZHU - Blame
Arlissa & Jonas Blue - Hearts Ain't Gonna Lie
Devin Dawson - Symptoms
The Vaccines - I Can't Quit
Sidney Gish - Where the Sidewalk Ends
Prelow - Goes to Shit
Fetty Wap & KDL - With You
Manu Crook$ - Presence
MGMT - Hand It Over
Black Rebel Motorcycle Club - Echo
I'm With Her - Game To Lose
Wolf Alice - Don’t Delete The Kisses (Charli XCX x Post Precious Remix)
Bahamas - Bad Boys Need Love Too
Oliver Tree - Upside Down
Raffaella - Sororicide
Schilly - B.A.M
Cassow - Flashbacks
Cozz - Questions
Breaking Benjamin - Red Cold River
Joan As Police Woman - Tell Me
Brothers Osborne - Shoot Me Straight
Handsome Ghost - Harvest Moon
The Dangerous Summer - Ghosts
Jeff Rosenstock - All This Useless Energy
Space Primates - My Life
Caitlyn Smith - Contact High
Rosie Carney - K
MILCK - This Is Not The End
H.E.R. - My Song
TobyMac - I just need U
Cory Asbury - Endless Alleluia
Bhad Bhabie - Both of Em
The Go! Team - All the Way LiveEmbed