New Music Friday 03/25/16 LyricsZAYN - sHe
Fifth Harmony - The Life
Fitz and The Tantrums - HandClap
Troye Sivan - YOUTH (Gryffin Remix)
Nick Jonas - Close feat. Tove Lo
Big Wild - Aftergold feat. Tove Styrke
Kiiara - Intention
Seven Lions - Coming Home feat. Mike Mains
Meghan Trainor - Watch Me Do
Flo Rida - Who's With Me
Hundred Waters - Show Me Love feat. Chance the Rapper, Moses Sumney & Robin Hannibal
Buffy Clyro - Wolves of Winter
The Lumineers - Cleopatra
Gnash - fragile (feat. Wrenn)
Disco Fries - Born Ready feat. Hope Murphy (Halogen Radio Edit)
Bonzai - Where Are U Now
Clairity - Broken Things
Ty Dolla $ign - Long Time feat. Quavo
SBTRKT - I FEEL YOUR PAIN feat. D.R.A.M. & Mabel
Rae Sremmurd - Over Here feat. Bobo Swae
Domo Genesis - Dapper feat. Anderson .Paak
Elephante - Closer feat. Bishop
The Range - Copper Wire
Emma Louise - Talk Baby Talk
Thrice - Blood On the Sand
SunDrones - Kill Me Baby
Rivvrs - I Will Follow You
Dive In - Don't Break Yourself Apart
Birdy - Wild Horses
JMR - Found My Religion
Florae - Real Love (Cahill Radio Mix)
Young Thug - With Them
Empire Cast - All Nite (Yo Gotti Remix)
Kendrick Lamar - untitled 07 | levitate
K. Michelle - If It Ain't Love
Elijah Blake - Whatever Happened
Giovanni James - Whutcha Want
RJD2 - Piece of What feat. Jordan Brown
ROMANS - Silence (AlunaGeorge Edit)
The Goo Goo Dolls - Over and Over
Kenny Chesney - Noise
Eric Bachmann - Carolina
Mt. Wolf - St. Michael
Yoke Lore - Heavy Love
Justin Jay - Weatherman
A. K. Paul - Landcruisin'
MAGIC! - Lay You Down Easy feat. Sean Paul
Corinne Bailey Rae - Stop Where You Are
Pell - The Wild
Highly Suspect - ClaudelandEmbed