New Music Friday 8/20/21 LyricsYoung Thug - Tick Tock
Trippie Redd - Rich MF (feat. Polo G & Lil Durk)
Skrillex - Donâ€™t Go (with Justin Bieber & Don Toliver)
Shawn Mendes - Summer of Love (Shawn Mendes & Tainy)
Lorde - Mood Ring
Ed Sheeran - Visiting Hours
Alesso - Chasing Stars (feat. James Bay)
Kane Brown - One Mississippi
Gunna - 9 TIMES OUTTA 10
Rod Wave - Already Won (feat. Lil Durk)
dvsn - Memories
Dream - Change My Clothes
Surfaces - Sheesh!
Clinton Kane - I GUESS I'M IN LOVE
James Blake - Life Is Not The Same
Sheff G - Run It Up (feat. Sleepy Hallow & A Boogie Wit Da Hoodie)
Kevin Abstract - SIERRA NIGHTS (feat. Ryan Beatty)
Sad Night Dynamite - PsychĞµdelic Views (feat. IDK)
LANY - nĞµver mind, let's break up
Jeremy Zucker - Cry with you
Remi Wolf - Quiet On Set
Bakar - The Mission
G-Eazy - Running Wild (Tumblr Girls 2) (feat. Kossisko)
ABRA - Unlock It (feat. Playboi Carti)
Cochise - POCKET ROCKET
Disclosure - In My Arms - Edit
khai dreams - Flowers
Keith Urban - Wild Hearts
YUNGBLUD - fleabag
Nija - Ease My Mind (Come Over)
Tiwa Savage - Somebodyâ€™s Son (Ft Brandy)
Matoma - Summer Feeling
Bastille - Thelma + Louise
Swae Lee - In The Dark (with JhenÃ© Aiko)
Jaden - Summer
Shenseea - Be Good
Feid - SI TÃš SUPIERAS - Bonus Track
Justin Quiles - La Botella
Felix Jaehn - I Got A Feeling
EMELINE - this is how i learn to say no
salem ilese - Ben & Jerry
Lyn Lapid - In My Mind
Sturgill Simpson - Juanita
JoJo - Worst (I Assume)
Shaybo - My Sister (feat. Jorja Smith)
King Promise - Ring My Line (feat. Headie One) ğŸ•’
Future Islands - Peach
Rxseboy - I'm So Good at Lying (feat. Powfu & Thomas Reid)
Cian Ducrot - Chewing Gum
Dillon Francis - Reaching Out
Riovaz - Leaving You
Jazz Cartier - Rock the Boat
Lute - Myself (feat. DEVN)
YFN Lucci - Like Me
Pitbull - I Feel Good
Lele Pons - Abajo y Arriba (with Juhn)
TOMORROW X TOGETHER - LO$ER=LOâ™¡ER
Boys World - Something in the Water
Leah Kate - Veronica
R3HAB - Runaway (with Sigala and JP Cooper)
Livingston - Message in a Bottle ğŸ•’
Jake Wesley Rogers - Weddings and Funerals
Sam Williams - Happy All The Time
Olivia Vedder - My Father's Daughter
Del Water Gap - Perfume
Pretty Boy Aaron - Delfino (Feel This Way)
Kyle Dion - Money
Cimafunk - Funk Aspirin
MO3 - In My Blood
Dame D.O.L.L.A - We The Ones (feat. Blxst & Tree Thomas)
Enchanting - Track & Field (feat. Kali) ğŸ•’
Ann Marie - Hate Love
Santana - Move ğŸ•’
Jake Bugg - About Last Night
Nathaniel Rateliff & The Night Sweats - Survivor
Switchfoot - lost â€˜cause
Ella Henderson - Risk It All
ë°•í˜œì§„ Park Hye Jin - I Need You ğŸ•’
JosÃ© GonzÃ¡lez - Swing
Niko Rubio - Saving Me ğŸ•’
BENNETT - Buzzed
Devin Kennedy - 10ft Tall
Red Velvet - Queendom
Carly Gibert - MTV Cribs
Caspr - Play Pretend (feat. Travis Barker)
LiL Lotus - Over and Over Again
Sam Fender - Aye
Sam Ezeh - Fantasy
KUNZITE - HALOHEAD
Shire T - L.D.R.A ğŸš
Shannon & The Clams - I Need You Bad ğŸ•’
BirdsFlyStoned - Grin On Me
Chris Janson - Bye Mom
Anderson East - Maybe We Never Die ğŸ•’
The Wombats - If You Ever Leave, I'm Coming with You
Asking Alexandria - Alone Again
Micah Emrich - rock bottom
Stephen Day - All This Space
Travis Greene - Close the Door (feat. Mali Music) ğŸ•’
Aaliyah - One In A MillionEmbed