New Music Tuesday 12/02/14 LyricsGwen Stefani - Spark The Fire
Wu-Tang Clan - A Better Tomorrow
Royal Tongues - The Balance
Avicii - The Nights
George Ezra - Cassy O'
Kygo - Firestone
Young Fathers - Soon Come Soon
Mary J. Blige - Follow
AURORA - Under Stars
HOLYCHILD - Running Behind
Noah Gundersen - Twenty-Something
Travi$ Scott - Mamacita
Bastille - Torn Apart (Bastille vs. GRADES)
George Maple - Vacant Space
School '94 - Like You
Griffin House - The Way I Was Made (Live from Prison)
Eliot Sumner - I Followed You Home
She & Him - Unchained Melody
Mikky Ekko - Time
Axwell^Ingrosso - Can't Hold Us Down
Deorro - Hit It
Omarion - Post To Be (feat. Chris Brown & Jhene Aiko)
Doomtree - Gray Duck
Yung Gud - Forever 2001
Little Boots - Taste It
Satellite Stories - The Trap
Colleen Green - Pay Attention
Seven Lions - The Fall
George Ezra - Get Lonely with Me
Enter Shikari - Never Let Go Of The Microscope
Pixies - Wave Of Mutilation (Peel Session)
Marian Hill - Lips
Mike Stud - Toast
The Griswolds - Beware the Dog (Live at Rubber Tracks)
Willie Nelson - Laws of Nature
Butch Walker - Bed On Fire
Dr. Dog - Heart It Races
Yo La Tengo - From a Motel 6
Blood Orange - Is It All Over My Face & Tower Of Meaning
ODESZA - Say My Name - Markus Schulz Remix
Catey Shaw - Cuddle Up
Alejandro Fernandez - Se Me Va La Voz - En Vivo Desde El Teatro RealEmbed