New Music Friday 4/10/20 LyricsTwenty One Pilots - Level of Concern
Selena Gomez - Boyfriend
Tory Lanez - Stupid Again
Oliver Tree - Let Me Down
Polo G - DND
Pink Sweat$ - Ride with Me
Alaina Castillo - no vuelvas a mirar atrás
Alesso - Midnight (feat. Liam Payne)
dvsn & Ty Dolla $ign - Dangerous City (feat. Buju Banton)
Jean Dawson - POWER FREAKS
Gryffin & Chris Lane - Hold You Tonight
Leon Bridges - Inside Friend (feat. John Mayer)
Charli XCX - forever
Black Eyed Peas, Ozuna & J. Rey Soul - MAMACITA
Rich Brian & Guapdad 4000 - Bali
Phoebe Bridgers - Kyoto
Alec Benjamin - Six Feet Apart
Alexander 23 - IDK You Yett
mxmtoon - lessons
Gracie Abrams - I miss you, I'm sorry
lilspirit - nothing2prove
RMR - DEALER
Usher, Lil Jon & Ludacris - SexBeat
Yella Beezy - Headlocc (feat. Young Thug)
Kevin George - When You're Alone
Remi Wolf - Woo!
Omar Apollo - Imagine U
Tash Sultana - Pretty Lady
Dove Cameron - Remember Me (feat. BIA)
Tatiana Hazel - Don't Care
(G)I-DLE - Oh my god
Lennon Stella - Fear of Being Alone
Kina - Wish I Was Better (feat. yaeow)
MadMarcc - Like Home (feat. Lil Baby)
The Strokes - Brooklyn Bridge to Chorus
Cautious Clay - Reaching (feat. Alex Isley & Raedio)
Isaac Dunbar - boy
Hayley Williams - My Friend
Washed Out - Too Late
Mindchatter - Scared to Go Home
Emanuel - Need You
Kid Ink - Just Chill
IDK - In My White Tee
Buddy & Kent Jamz - She Think
Alina Baraz - Endlessly
Au/Ra - Ideas
Gorillaz - Aries (feat. Peter Hook & Georiga)
Joy Crookes - Anyone But Me
SHY Martin - can I call you back?
Mt. Joy - My Vibe
Kenny Chesney - Knowing You
Willie Jones - Back Porch
Almondmilkhunni - Bandana
J.I the Prince of N.Y - Proud Of Me
Rico Nasty - Popstar
Nieman J, Eric Bellinger & Joe Moses - Cheat Code Mode (feat. Young Thug)
Diplo & Wax Motif - Love To The World
Michael Calfan & Martin Solveig - No Lie
Stay Over - Happy
Julian Lamadrid - My Time
India Shawn - NOT TOO DEEP (feat. 6LACK)
Toni Braxton - Do It
2KBABY - OLD SOUL (feat. G Herbo)
Mozzy - Pricetag (feat. Polo G & Lil Poppa)
Fredo Bang - Saucy
Ambré - Slip (feat. BEAM)
Becca Mancari - Hunter
Hamilton Leithauser - The Garbage Men
Laura Marling - Held Down
Gregory Porter - Thank You
Maddie & Tae - I Don't Need To Know
Tenille Townes - The Most Beautiful Things
Stalking Gia - The Kindest Thing
Phem & Alison Wonderland - W.W.C.B.D.
Mr. Popular - Nowhere To Hide
Sky Rompiendo, Feid, Jowell & Randy - Le Creo
E-40 - Go
Shy Glizzy - Lonely Vibes
Rexx Life Raj
Quadeca - WHERE'D YOU GO?
Lil Boom - crying in da club
Jany Green - Suffocate
Genevieve Stokes - Running Away
Ambar Lucid - Universe
Lil Loaded - Shotta Shit
YSN Flow - Prescription
Dee Watkins - Talk Shit (feat. Tai Boujie)
Symba - Birds In The Bando
Oscar Welsh - Weird Times
gnash - leave
Savage Ga$p & Marvy Ayy - Simp Anthem
Asher Roth - Hunnid (feat. Joyce Wrice)
Lil Gotit - Bricks In The Attic
STRFKR - Dear Stranger
DANIEL SAINT BLACK - Learning to Live Again
NEFFEX - New Beginnings
NoCap - TheHoodDoctor
22Gz - No Questions
Bino Rideaux - Pride 2 The SideEmbed